repo,index,ts,add,del,dif
vscode,8,2016-01-02 21:00:00,19433,-13382,32815
vscode,9,2016-01-09 21:00:00,24896,-22917,47813
vscode,10,2016-01-16 21:00:00,28716,-15250,43966
vscode,11,2016-01-23 21:00:00,5400,-2856,8256
vscode,12,2016-01-30 21:00:00,13161,-11065,24226
vscode,13,2016-02-06 21:00:00,11515,-10727,22242
vscode,14,2016-02-13 21:00:00,45437,-16425,61862
vscode,15,2016-02-20 21:00:00,12120,-10610,22730
vscode,16,2016-02-27 21:00:00,11694,-13010,24704
vscode,17,2016-03-05 21:00:00,75592,-37068,112660
vscode,18,2016-03-12 21:00:00,12300,-4447,16747
vscode,19,2016-03-19 21:00:00,6815,-8533,15348
vscode,20,2016-03-26 21:00:00,35134,-43877,79011
vscode,21,2016-04-02 21:00:00,12302,-5753,18055
vscode,22,2016-04-09 21:00:00,149319,-55833,205152
vscode,23,2016-04-16 21:00:00,20241,-12365,32606
vscode,24,2016-04-23 21:00:00,7163,-5563,12726
vscode,25,2016-04-30 21:00:00,19197,-17758,36955
vscode,26,2016-05-07 21:00:00,12832,-7848,20680
vscode,27,2016-05-14 21:00:00,32007,-24585,56592
vscode,28,2016-05-21 21:00:00,17608,-8302,25910
vscode,29,2016-05-28 21:00:00,20009,-16843,36852
vscode,30,2016-06-04 21:00:00,38978,-139778,178756
vscode,31,2016-06-11 21:00:00,49434,-14194,63628
vscode,32,2016-06-18 21:00:00,15197,-80645,95842
vscode,33,2016-06-25 21:00:00,14819,-25069,39888
vscode,34,2016-07-02 21:00:00,14283,-12991,27274
vscode,35,2016-07-09 21:00:00,12277,-10864,23141
vscode,36,2016-07-16 21:00:00,8140,-3988,12128
vscode,37,2016-07-23 21:00:00,3953,-3188,7141
vscode,38,2016-07-30 21:00:00,25278,-19578,44856
vscode,39,2016-08-06 21:00:00,11805,-10722,22527
vscode,40,2016-08-13 21:00:00,26151,-22838,48989
vscode,41,2016-08-20 21:00:00,14154,-7253,21407
vscode,42,2016-08-27 21:00:00,10733,-4955,15688
vscode,43,2016-09-03 21:00:00,18275,-12613,30888
vscode,44,2016-09-10 21:00:00,22008,-21291,43299
vscode,45,2016-09-17 21:00:00,69383,-67668,137051
vscode,46,2016-09-24 21:00:00,5772,-3434,9206
vscode,47,2016-10-01 21:00:00,30978,-39906,70884
vscode,48,2016-10-08 21:00:00,63306,-141467,204773
vscode,49,2016-10-15 21:00:00,27193,-13581,40774
vscode,50,2016-10-22 21:00:00,23773,-18506,42279
vscode,51,2016-10-29 21:00:00,25107,-18581,43688
vscode,52,2016-11-05 21:00:00,35932,-26488,62420
vscode,53,2016-11-12 21:00:00,77808,-8796,86604
vscode,54,2016-11-19 21:00:00,18397,-74705,93102
vscode,55,2016-11-26 21:00:00,15389,-9653,25042
vscode,56,2016-12-03 21:00:00,8672,-6716,15388
vscode,57,2016-12-10 21:00:00,17654,-14084,31738
vscode,58,2016-12-17 21:00:00,6114,-5572,11686
vscode,59,2016-12-24 21:00:00,8966,-6912,15878
vscode,60,2016-12-31 21:00:00,148321,-147179,295500
vscode,61,2017-01-07 21:00:00,15921,-8342,24263
vscode,62,2017-01-14 21:00:00,20402,-11886,32288
vscode,63,2017-01-21 21:00:00,12202,-28244,40446
vscode,64,2017-01-28 21:00:00,23629,-24959,48588
vscode,65,2017-02-04 21:00:00,14315,-6632,20947
vscode,66,2017-02-11 21:00:00,17149,-12783,29932
vscode,67,2017-02-18 21:00:00,8621,-6230,14851
vscode,68,2017-02-25 21:00:00,27621,-15525,43146
vscode,69,2017-03-04 21:00:00,20391,-14223,34614
vscode,70,2017-03-11 21:00:00,30053,-14869,44922
vscode,71,2017-03-18 21:00:00,35846,-26264,62110
vscode,72,2017-03-25 21:00:00,11558,-7283,18841
vscode,73,2017-04-01 21:00:00,13308,-10624,23932
vscode,74,2017-04-08 21:00:00,9838,-5741,15579
vscode,75,2017-04-15 21:00:00,33029,-30197,63226
vscode,76,2017-04-22 21:00:00,23113,-45885,68998
vscode,77,2017-04-29 21:00:00,9806,-18721,28527
vscode,78,2017-05-06 21:00:00,21448,-14770,36218
vscode,79,2017-05-13 21:00:00,27721,-45410,73131
vscode,80,2017-05-20 21:00:00,51631,-24593,76224
vscode,81,2017-05-27 21:00:00,7708,-5093,12801
vscode,82,2017-06-03 21:00:00,11845,-9047,20892
vscode,83,2017-06-10 21:00:00,32809,-60086,92895
vscode,84,2017-06-17 21:00:00,34194,-25460,59654
vscode,85,2017-06-24 21:00:00,15099,-8017,23116
vscode,86,2017-07-01 21:00:00,7486,-4560,12046
vscode,87,2017-07-08 21:00:00,11479,-7559,19038
vscode,88,2017-07-15 21:00:00,15633,-7466,23099
vscode,89,2017-07-22 21:00:00,8936,-4576,13512
vscode,90,2017-07-29 21:00:00,2384,-3620,6004
vscode,91,2017-08-05 21:00:00,4528,-3620,8148
vscode,92,2017-08-12 21:00:00,14116,-11032,25148
vscode,93,2017-08-19 21:00:00,31488,-5765,37253
vscode,94,2017-08-26 21:00:00,6697,-7794,14491
vscode,95,2017-09-02 21:00:00,29725,-19416,49141
vscode,96,2017-09-09 21:00:00,11748,-8415,20163
vscode,97,2017-09-16 21:00:00,16308,-11022,27330
vscode,98,2017-09-23 21:00:00,11272,-10095,21367
vscode,99,2017-09-30 21:00:00,12642,-8878,21520
vscode,100,2017-10-07 21:00:00,19017,-10717,29734
vscode,101,2017-10-14 21:00:00,16298,-13112,29410
vscode,102,2017-10-21 21:00:00,12110,-7663,19773
vscode,103,2017-10-28 21:00:00,4694,-3278,7972
vscode,104,2017-11-04 21:00:00,63613,-62350,125963
vscode,105,2017-11-11 21:00:00,30298,-12690,42988
vscode,106,2017-11-18 21:00:00,26145,-18931,45076
vscode,107,2017-11-25 21:00:00,25055,-5999,31054
vscode,108,2017-12-02 21:00:00,8142,-13279,21421
vscode,109,2017-12-09 21:00:00,53285,-21557,74842
vscode,110,2017-12-16 21:00:00,14456,-10053,24509
vscode,111,2017-12-23 21:00:00,2332,-1805,4137
vscode,112,2017-12-30 21:00:00,20125,-18410,38535
vscode,113,2018-01-06 21:00:00,9363,-5458,14821
vscode,114,2018-01-13 21:00:00,21404,-14350,35754
vscode,115,2018-01-20 21:00:00,48056,-45022,93078
vscode,116,2018-01-27 21:00:00,9702,-5335,15037
vscode,117,2018-02-03 21:00:00,26030,-22218,48248
vscode,118,2018-02-10 21:00:00,14128,-9766,23894
vscode,119,2018-02-17 21:00:00,59360,-45402,104762
vscode,120,2018-02-24 21:00:00,19955,-14346,34301
vscode,121,2018-03-03 21:00:00,63588,-44915,108503
vscode,122,2018-03-10 21:00:00,29260,-25556,54816
vscode,123,2018-03-17 21:00:00,46160,-42119,88279
vscode,124,2018-03-24 21:00:00,15025,-8773,23798
vscode,125,2018-03-31 21:00:00,31156,-24301,55457
vscode,126,2018-04-07 21:00:00,36819,-27376,64195
vscode,127,2018-04-14 21:00:00,30297,-20291,50588
vscode,128,2018-04-21 21:00:00,13811,-16855,30666
vscode,129,2018-04-28 21:00:00,23043,-14962,38005
vscode,130,2018-05-05 21:00:00,18797,-8990,27787
vscode,131,2018-05-12 21:00:00,34048,-33659,67707
vscode,132,2018-05-19 21:00:00,47684,-50960,98644
vscode,133,2018-05-26 21:00:00,12856,-5459,18315
vscode,134,2018-06-02 21:00:00,58861,-41663,100524
vscode,135,2018-06-09 21:00:00,20561,-12820,33381
vscode,136,2018-06-16 21:00:00,11511,-7149,18660
vscode,137,2018-06-23 21:00:00,18699,-14110,32809
vscode,138,2018-06-30 21:00:00,10634,-9421,20055
vscode,139,2018-07-07 21:00:00,11124,-7544,18668
vscode,140,2018-07-14 21:00:00,10650,-5894,16544
vscode,141,2018-07-21 21:00:00,29705,-27615,57320
vscode,142,2018-07-28 21:00:00,3145,-1991,5136
vscode,143,2018-08-04 21:00:00,17945,-9469,27414
vscode,144,2018-08-11 21:00:00,6786,-8130,14916
vscode,145,2018-08-18 21:00:00,13106,-10619,23725
vscode,146,2018-08-25 21:00:00,4649,-152461,157110
vscode,147,2018-09-01 21:00:00,15573,-16651,32224
vscode,148,2018-09-08 21:00:00,9101,-6279,15380
vscode,149,2018-09-15 21:00:00,11655,-6071,17726
vscode,150,2018-09-22 21:00:00,10916,-6733,17649
vscode,151,2018-09-29 21:00:00,23193,-33962,57155
vscode,152,2018-10-06 21:00:00,17362,-15737,33099
vscode,153,2018-10-13 21:00:00,12439,-12289,24728
vscode,154,2018-10-20 21:00:00,10848,-8009,18857
vscode,155,2018-10-27 21:00:00,3244,-2084,5328
vscode,156,2018-11-03 21:00:00,8751,-5752,14503
vscode,157,2018-11-10 21:00:00,11888,-13235,25123
vscode,158,2018-11-17 21:00:00,8105,-8771,16876
vscode,159,2018-11-24 21:00:00,16417,-12296,28713
vscode,160,2018-12-01 21:00:00,6793,-4781,11574
vscode,161,2018-12-08 21:00:00,16290,-17751,34041
vscode,162,2018-12-15 21:00:00,12502,-11766,24268
vscode,163,2018-12-22 21:00:00,4957,-4935,9892
vscode,164,2018-12-29 21:00:00,6883,-7437,14320
vscode,165,2019-01-05 21:00:00,8276,-5847,14123
vscode,166,2019-01-12 21:00:00,6572,-4222,10794
vscode,167,2019-01-19 21:00:00,15812,-11532,27344
vscode,168,2019-01-26 21:00:00,5427,-5324,10751
vscode,169,2019-02-02 21:00:00,145667,-143480,289147
vscode,170,2019-02-09 21:00:00,23200,-17604,40804
vscode,171,2019-02-16 21:00:00,26982,-24937,51919
vscode,172,2019-02-23 21:00:00,2793,-2125,4918
vscode,173,2019-03-02 21:00:00,35008,-30074,65082
vscode,174,2019-03-09 21:00:00,18186,-13091,31277
vscode,175,2019-03-16 21:00:00,27713,-22655,50368
vscode,176,2019-03-23 21:00:00,10415,-9087,19502
vscode,177,2019-03-30 21:00:00,21131,-19389,40520
vscode,178,2019-04-06 21:00:00,31079,-23232,54311
vscode,179,2019-04-13 21:00:00,16658,-14686,31344
vscode,180,2019-04-20 21:00:00,4024,-3434,7458
vscode,181,2019-04-27 21:00:00,2750,-2077,4827
vscode,182,2019-05-04 21:00:00,4470,-3747,8217
vscode,183,2019-05-11 21:00:00,4922,-3055,7977
vscode,184,2019-05-18 21:00:00,18199,-10899,29098
vscode,185,2019-05-25 21:00:00,6220,-2143,8363
vscode,186,2019-06-01 21:00:00,33008,-17058,50066
vscode,187,2019-06-08 21:00:00,26640,-14887,41527
vscode,188,2019-06-15 21:00:00,20866,-19185,40051
vscode,189,2019-06-22 21:00:00,10325,-9504,19829
vscode,190,2019-06-29 21:00:00,28515,-20955,49470
vscode,191,2019-07-06 21:00:00,29880,-22655,52535
vscode,192,2019-07-13 21:00:00,27426,-23808,51234
vscode,193,2019-07-20 21:00:00,24491,-4944,29435
vscode,194,2019-07-27 21:00:00,2658,-1591,4249
vscode,195,2019-08-03 21:00:00,13726,-11729,25455
vscode,196,2019-08-10 21:00:00,25228,-20324,45552
vscode,197,2019-08-17 21:00:00,8678,-4765,13443
vscode,198,2019-08-24 21:00:00,13126,-29407,42533
vscode,199,2019-08-31 21:00:00,32473,-20999,53472
vscode,200,2019-09-07 21:00:00,16887,-11991,28878
vscode,201,2019-09-14 21:00:00,38330,-19971,58301
vscode,202,2019-09-21 21:00:00,14256,-13797,28053
vscode,203,2019-09-28 21:00:00,9208,-8606,17814
vscode,204,2019-10-05 21:00:00,9865,-7087,16952
vscode,205,2019-10-12 21:00:00,11760,-10255,22015
vscode,206,2019-10-19 21:00:00,33300,-29509,62809
vscode,207,2019-10-26 21:00:00,8001,-8025,16026
vscode,208,2019-11-02 21:00:00,18305,-14084,32389
vscode,209,2019-11-09 21:00:00,15376,-11902,27278
vscode,210,2019-11-16 21:00:00,17678,-11105,28783
vscode,211,2019-11-23 21:00:00,10698,-6282,16980
vscode,212,2019-11-30 21:00:00,6024,-4428,10452
vscode,213,2019-12-07 21:00:00,21494,-22037,43531
vscode,214,2019-12-14 21:00:00,16251,-10165,26416
vscode,215,2019-12-21 21:00:00,3034,-999,4033
vscode,216,2019-12-28 21:00:00,4001,-5271,9272
vscode,217,2020-01-04 21:00:00,18011,-10817,28828
vscode,218,2020-01-11 21:00:00,20124,-12032,32156
vscode,219,2020-01-18 21:00:00,15173,-9581,24754
vscode,220,2020-01-25 21:00:00,6735,-4472,11207
vscode,221,2020-02-01 21:00:00,98903,-95695,194598
vscode,222,2020-02-08 21:00:00,18533,-12415,30948
vscode,223,2020-02-15 21:00:00,19247,-11758,31005
vscode,224,2020-02-22 21:00:00,11600,-13436,25036
vscode,225,2020-02-29 21:00:00,36488,-28274,64762
vscode,226,2020-03-07 21:00:00,18757,-11368,30125
vscode,227,2020-03-14 21:00:00,19133,-13284,32417
vscode,228,2020-03-21 21:00:00,36157,-42390,78547
vscode,229,2020-03-28 21:00:00,8244,-5768,14012
vscode,230,2020-04-04 21:00:00,16959,-14589,31548
vscode,231,2020-04-11 21:00:00,17386,-12385,29771
vscode,232,2020-04-18 21:00:00,17821,-10641,28462
vscode,233,2020-04-25 21:00:00,6296,-3592,9888
vscode,234,2020-05-02 21:00:00,11977,-7324,19301
vscode,235,2020-05-09 21:00:00,21236,-15681,36917
vscode,236,2020-05-16 21:00:00,15942,-7312,23254
vscode,237,2020-05-23 21:00:00,12740,-8818,21558
vscode,238,2020-05-30 21:00:00,6984,-4006,10990
vscode,239,2020-06-06 21:00:00,15858,-11439,27297
vscode,240,2020-06-13 21:00:00,24740,-20263,45003
vscode,241,2020-06-20 21:00:00,11644,-8431,20075
vscode,242,2020-06-27 21:00:00,6812,-6974,13786
vscode,243,2020-07-04 21:00:00,9693,-7111,16804
vscode,244,2020-07-11 21:00:00,10882,-6040,16922
vscode,245,2020-07-18 21:00:00,22081,-17266,39347
vscode,246,2020-07-25 21:00:00,9589,-6726,16315
vscode,247,2020-08-01 21:00:00,3391,-2094,5485
vscode,248,2020-08-08 21:00:00,8684,-5988,14672
vscode,249,2020-08-15 21:00:00,11058,-13201,24259
vscode,250,2020-08-22 21:00:00,14989,-10309,25298
vscode,251,2020-08-29 21:00:00,7567,-6513,14080
vscode,252,2020-09-05 21:00:00,9327,-7262,16589
vscode,253,2020-09-12 21:00:00,13482,-10754,24236
vscode,254,2020-09-19 21:00:00,6914,-12104,19018
vscode,255,2020-09-26 21:00:00,5000,-3664,8664
vscode,256,2020-10-03 21:00:00,5998,-4142,10140
vscode,257,2020-10-10 21:00:00,4612,-2201,6813
vscode,258,2020-10-17 21:00:00,8317,-4528,12845
vscode,259,2020-10-24 21:00:00,7252,-3205,10457
vscode,260,2020-10-31 21:00:00,29720,-28073,57793
vscode,261,2020-11-07 21:00:00,11040,-7451,18491
vscode,262,2020-11-14 21:00:00,15907,-9999,25906
vscode,263,2020-11-21 21:00:00,15172,-11005,26177
vscode,264,2020-11-28 21:00:00,4061,-2778,6839
vscode,265,2020-12-05 21:00:00,8758,-6293,15051
vscode,266,2020-12-12 21:00:00,30510,-39636,70146
vscode,267,2020-12-19 21:00:00,8287,-5975,14262
vscode,268,2020-12-26 21:00:00,3276,-2269,5545
vscode,269,2021-01-02 21:00:00,25006,-17572,42578
vscode,270,2021-01-09 21:00:00,24765,-309575,334340
vscode,271,2021-01-16 21:00:00,179491,-14616,194107
vscode,272,2021-01-23 21:00:00,141178,-7448,148626
vscode,273,2021-01-30 21:00:00,18712,-15426,34138
vscode,274,2021-02-06 21:00:00,26347,-21402,47749
vscode,275,2021-02-13 21:00:00,17687,-28043,45730
vscode,276,2021-02-20 21:00:00,9735,-8050,17785
vscode,277,2021-02-27 21:00:00,13264,-12304,25568
vscode,278,2021-03-06 21:00:00,12551,-7987,20538
vscode,279,2021-03-13 21:00:00,13213,-7583,20796
vscode,280,2021-03-20 21:00:00,14455,-8079,22534
vscode,281,2021-03-27 21:00:00,49691,-21404,71095
vscode,282,2021-04-03 21:00:00,19175,-15489,34664
vscode,283,2021-04-10 21:00:00,21099,-17574,38673
vscode,284,2021-04-17 21:00:00,17356,-13167,30523
vscode,285,2021-04-24 21:00:00,7426,-5165,12591
vscode,286,2021-05-01 21:00:00,18479,-15521,34000
vscode,287,2021-05-08 21:00:00,19831,-12890,32721
vscode,288,2021-05-15 21:00:00,24273,-15444,39717
vscode,289,2021-05-22 21:00:00,16893,-9625,26518
vscode,290,2021-05-29 21:00:00,8560,-7035,15595
vscode,291,2021-06-05 21:00:00,15673,-11845,27518
vscode,292,2021-06-12 21:00:00,15773,-8601,24374
vscode,293,2021-06-19 21:00:00,10107,-5133,15240
vscode,294,2021-06-26 21:00:00,9757,-4132,13889
vscode,295,2021-07-03 21:00:00,13925,-11462,25387
vscode,296,2021-07-10 21:00:00,9951,-8523,18474
vscode,297,2021-07-17 21:00:00,15015,-10399,25414
vscode,298,2021-07-24 21:00:00,5281,-1711,6992
vscode,299,2021-07-31 21:00:00,12334,-11478,23812
vscode,300,2021-08-07 21:00:00,6774,-3790,10564
vscode,301,2021-08-14 21:00:00,10916,-6711,17627
vscode,302,2021-08-21 21:00:00,2914,-1750,4664
ember.js,245,2016-01-02 21:00:00,77,-66,143
ember.js,246,2016-01-09 21:00:00,233,-55,288
ember.js,247,2016-01-16 21:00:00,106,-99,205
ember.js,248,2016-01-23 21:00:00,1891,-1336,3227
ember.js,249,2016-01-30 21:00:00,2717,-1734,4451
ember.js,250,2016-02-06 21:00:00,1830,-2520,4350
ember.js,251,2016-02-13 21:00:00,399,-153,552
ember.js,252,2016-02-20 21:00:00,1609,-366,1975
ember.js,253,2016-02-27 21:00:00,6536,-668,7204
ember.js,254,2016-03-05 21:00:00,2029,-1121,3150
ember.js,255,2016-03-12 21:00:00,3622,-2883,6505
ember.js,256,2016-03-19 21:00:00,3909,-8581,12490
ember.js,257,2016-03-26 21:00:00,2742,-2860,5602
ember.js,258,2016-04-02 21:00:00,3696,-4189,7885
ember.js,259,2016-04-09 21:00:00,3602,-2974,6576
ember.js,260,2016-04-16 21:00:00,2344,-1590,3934
ember.js,261,2016-04-23 21:00:00,3037,-2243,5280
ember.js,262,2016-04-30 21:00:00,3828,-2062,5890
ember.js,263,2016-05-07 21:00:00,3788,-4419,8207
ember.js,264,2016-05-14 21:00:00,11359,-7911,19270
ember.js,265,2016-05-21 21:00:00,2365,-5333,7698
ember.js,266,2016-05-28 21:00:00,970,-912,1882
ember.js,267,2016-06-04 21:00:00,1038,-4428,5466
ember.js,268,2016-06-11 21:00:00,8326,-8587,16913
ember.js,269,2016-06-18 21:00:00,1059,-445,1504
ember.js,270,2016-06-25 21:00:00,1320,-1364,2684
ember.js,271,2016-07-02 21:00:00,71,-43,114
ember.js,272,2016-07-09 21:00:00,979,-402,1381
ember.js,273,2016-07-16 21:00:00,1844,-2536,4380
ember.js,274,2016-07-23 21:00:00,2717,-2784,5501
ember.js,275,2016-07-30 21:00:00,2910,-1725,4635
ember.js,276,2016-08-06 21:00:00,575,-870,1445
ember.js,277,2016-08-13 21:00:00,805,-134,939
ember.js,278,2016-08-20 21:00:00,2511,-1178,3689
ember.js,279,2016-08-27 21:00:00,7785,-15207,22992
ember.js,280,2016-09-03 21:00:00,4522,-2575,7097
ember.js,281,2016-09-10 21:00:00,1717,-1381,3098
ember.js,282,2016-09-17 21:00:00,440,-252,692
ember.js,283,2016-09-24 21:00:00,1479,-707,2186
ember.js,284,2016-10-01 21:00:00,4769,-7368,12137
ember.js,285,2016-10-08 21:00:00,2086,-628,2714
ember.js,286,2016-10-15 21:00:00,399,-231,630
ember.js,287,2016-10-22 21:00:00,6904,-325,7229
ember.js,288,2016-10-29 21:00:00,374,-150,524
ember.js,289,2016-11-05 21:00:00,947,-702,1649
ember.js,290,2016-11-12 21:00:00,612,-668,1280
ember.js,291,2016-11-19 21:00:00,304,-320,624
ember.js,292,2016-11-26 21:00:00,2038,-1759,3797
ember.js,293,2016-12-03 21:00:00,400,-99,499
ember.js,294,2016-12-10 21:00:00,1313,-703,2016
ember.js,295,2016-12-17 21:00:00,728,-1001,1729
ember.js,296,2016-12-24 21:00:00,1009,-693,1702
ember.js,297,2016-12-31 21:00:00,1724,-872,2596
ember.js,298,2017-01-07 21:00:00,710,-703,1413
ember.js,299,2017-01-14 21:00:00,1202,-1213,2415
ember.js,300,2017-01-21 21:00:00,184,-608,792
ember.js,301,2017-01-28 21:00:00,178,-43,221
ember.js,302,2017-02-04 21:00:00,131,-108,239
ember.js,303,2017-02-11 21:00:00,26,-33,59
ember.js,304,2017-02-18 21:00:00,416,-255,671
ember.js,305,2017-02-25 21:00:00,327,-125,452
ember.js,306,2017-03-04 21:00:00,300,-118,418
ember.js,307,2017-03-11 21:00:00,3247,-1845,5092
ember.js,308,2017-03-18 21:00:00,1608,-1683,3291
ember.js,309,2017-03-25 21:00:00,809,-647,1456
ember.js,310,2017-04-01 21:00:00,540,-439,979
ember.js,311,2017-04-08 21:00:00,142,-113,255
ember.js,312,2017-04-15 21:00:00,120,-77,197
ember.js,313,2017-04-22 21:00:00,1020,-1430,2450
ember.js,314,2017-04-29 21:00:00,200,-457,657
ember.js,315,2017-05-06 21:00:00,639,-562,1201
ember.js,316,2017-05-13 21:00:00,1036,-1029,2065
ember.js,317,2017-05-20 21:00:00,1232,-1148,2380
ember.js,318,2017-05-27 21:00:00,1557,-1466,3023
ember.js,319,2017-06-03 21:00:00,1989,-1749,3738
ember.js,320,2017-06-10 21:00:00,1813,-1681,3494
ember.js,321,2017-06-17 21:00:00,1541,-1602,3143
ember.js,322,2017-06-24 21:00:00,1617,-1773,3390
ember.js,323,2017-07-01 21:00:00,601,-577,1178
ember.js,324,2017-07-08 21:00:00,187,-213,400
ember.js,325,2017-07-15 21:00:00,970,-823,1793
ember.js,326,2017-07-22 21:00:00,993,-852,1845
ember.js,327,2017-07-29 21:00:00,14,-17,31
ember.js,328,2017-08-05 21:00:00,468,-386,854
ember.js,329,2017-08-12 21:00:00,468,-109,577
ember.js,330,2017-08-19 21:00:00,180,-58,238
ember.js,331,2017-08-26 21:00:00,2416,-1848,4264
ember.js,332,2017-09-02 21:00:00,217,-464,681
ember.js,333,2017-09-09 21:00:00,424,-355,779
ember.js,334,2017-09-16 21:00:00,66,-12,78
ember.js,335,2017-09-23 21:00:00,194,-144,338
ember.js,336,2017-09-30 21:00:00,431,-384,815
ember.js,337,2017-10-07 21:00:00,72,-29,101
ember.js,338,2017-10-14 21:00:00,8114,-7804,15918
ember.js,339,2017-10-21 21:00:00,2135,-1466,3601
ember.js,340,2017-10-28 21:00:00,784,-469,1253
ember.js,341,2017-11-04 21:00:00,676,-716,1392
ember.js,342,2017-11-11 21:00:00,799,-629,1428
ember.js,343,2017-11-18 21:00:00,68,-29,97
ember.js,344,2017-11-25 21:00:00,1473,-4135,5608
ember.js,345,2017-12-02 21:00:00,4967,-3885,8852
ember.js,346,2017-12-09 21:00:00,3303,-2518,5821
ember.js,347,2017-12-16 21:00:00,4032,-3386,7418
ember.js,348,2017-12-23 21:00:00,2209,-2177,4386
ember.js,349,2017-12-30 21:00:00,11183,-8615,19798
ember.js,350,2018-01-06 21:00:00,6480,-8632,15112
ember.js,351,2018-01-13 21:00:00,3940,-4665,8605
ember.js,352,2018-01-20 21:00:00,1829,-2435,4264
ember.js,353,2018-01-27 21:00:00,975,-985,1960
ember.js,354,2018-02-03 21:00:00,1314,-987,2301
ember.js,355,2018-02-10 21:00:00,3881,-4040,7921
ember.js,356,2018-02-17 21:00:00,2368,-745,3113
ember.js,357,2018-02-24 21:00:00,824,-554,1378
ember.js,358,2018-03-03 21:00:00,4105,-3899,8004
ember.js,359,2018-03-10 21:00:00,2286,-2243,4529
ember.js,360,2018-03-17 21:00:00,2191,-1409,3600
ember.js,361,2018-03-24 21:00:00,97402,-85226,182628
ember.js,362,2018-03-31 21:00:00,1263,-1090,2353
ember.js,363,2018-04-07 21:00:00,14930,-14721,29651
ember.js,364,2018-04-14 21:00:00,11886,-11489,23375
ember.js,365,2018-04-21 21:00:00,377,-306,683
ember.js,366,2018-04-28 21:00:00,995,-467,1462
ember.js,367,2018-05-05 21:00:00,1678,-1423,3101
ember.js,368,2018-05-12 21:00:00,4347,-3117,7464
ember.js,369,2018-05-19 21:00:00,9415,-7559,16974
ember.js,370,2018-05-26 21:00:00,421,-339,760
ember.js,371,2018-06-02 21:00:00,800,-341,1141
ember.js,372,2018-06-09 21:00:00,1494,-850,2344
ember.js,373,2018-06-16 21:00:00,887,-593,1480
ember.js,374,2018-06-23 21:00:00,278,-124,402
ember.js,375,2018-06-30 21:00:00,233,-244,477
ember.js,376,2018-07-07 21:00:00,404,-93,497
ember.js,377,2018-07-14 21:00:00,78,-81,159
ember.js,378,2018-07-21 21:00:00,44,-61,105
ember.js,379,2018-07-28 21:00:00,369,-21,390
ember.js,380,2018-08-04 21:00:00,71,-28,99
ember.js,381,2018-08-11 21:00:00,76983,-76508,153491
ember.js,382,2018-08-18 21:00:00,16483,-15662,32145
ember.js,383,2018-08-25 21:00:00,681,-781,1462
ember.js,384,2018-09-01 21:00:00,6996,-8398,15394
ember.js,385,2018-09-08 21:00:00,142,-102,244
ember.js,386,2018-09-15 21:00:00,425,-237,662
ember.js,387,2018-09-22 21:00:00,892,-504,1396
ember.js,388,2018-09-29 21:00:00,4390,-1501,5891
ember.js,389,2018-10-06 21:00:00,557,-164,721
ember.js,390,2018-10-13 21:00:00,1383,-752,2135
ember.js,391,2018-10-20 21:00:00,932,-189,1121
ember.js,392,2018-10-27 21:00:00,183,-20,203
ember.js,393,2018-11-03 21:00:00,1847,-1773,3620
ember.js,394,2018-11-10 21:00:00,846,-582,1428
ember.js,395,2018-11-17 21:00:00,138,-45,183
ember.js,396,2018-11-24 21:00:00,609,-199,808
ember.js,397,2018-12-01 21:00:00,6209,-4371,10580
ember.js,398,2018-12-08 21:00:00,3607,-4623,8230
ember.js,399,2018-12-15 21:00:00,647,-360,1007
ember.js,400,2018-12-22 21:00:00,314,-114,428
ember.js,401,2018-12-29 21:00:00,56,-50,106
ember.js,402,2019-01-05 21:00:00,1272,-909,2181
ember.js,403,2019-01-12 21:00:00,1941,-1075,3016
ember.js,404,2019-01-19 21:00:00,320,-303,623
ember.js,405,2019-01-26 21:00:00,749,-794,1543
ember.js,406,2019-02-02 21:00:00,2159,-861,3020
ember.js,407,2019-02-09 21:00:00,1379,-302,1681
ember.js,408,2019-02-16 21:00:00,600,-545,1145
ember.js,409,2019-02-23 21:00:00,114983,-101317,216300
ember.js,410,2019-03-02 21:00:00,2419,-2431,4850
ember.js,411,2019-03-09 21:00:00,9121,-7289,16410
ember.js,412,2019-03-16 21:00:00,12280,-7056,19336
ember.js,413,2019-03-23 21:00:00,3451,-2139,5590
ember.js,414,2019-03-30 21:00:00,2592,-1401,3993
ember.js,415,2019-04-06 21:00:00,672,-356,1028
ember.js,416,2019-04-13 21:00:00,4348,-2812,7160
ember.js,417,2019-04-20 21:00:00,3097,-495,3592
ember.js,418,2019-04-27 21:00:00,383,-226,609
ember.js,419,2019-05-04 21:00:00,102,-27,129
ember.js,420,2019-05-11 21:00:00,80,-65,145
ember.js,421,2019-05-18 21:00:00,101,-5,106
ember.js,422,2019-05-25 21:00:00,975,-397,1372
ember.js,423,2019-06-01 21:00:00,577,-595,1172
ember.js,424,2019-06-08 21:00:00,345,-374,719
ember.js,425,2019-06-15 21:00:00,555,-448,1003
ember.js,426,2019-06-22 21:00:00,696,-310,1006
ember.js,427,2019-06-29 21:00:00,199,-7,206
ember.js,428,2019-07-06 21:00:00,1090,-996,2086
ember.js,429,2019-07-13 21:00:00,369,-180,549
ember.js,430,2019-07-20 21:00:00,444,-361,805
ember.js,431,2019-07-27 21:00:00,59,-140,199
ember.js,432,2019-08-03 21:00:00,7149,-8560,15709
ember.js,433,2019-08-10 21:00:00,1076,-884,1960
ember.js,434,2019-08-17 21:00:00,504,-165,669
ember.js,435,2019-08-24 21:00:00,230,-231,461
ember.js,436,2019-08-31 21:00:00,5796,-1087,6883
ember.js,437,2019-09-07 21:00:00,404,-127,531
ember.js,438,2019-09-14 21:00:00,1908,-851,2759
ember.js,439,2019-09-21 21:00:00,78,-29,107
ember.js,440,2019-09-28 21:00:00,260,-213,473
ember.js,441,2019-10-05 21:00:00,193,-103,296
ember.js,442,2019-10-12 21:00:00,234,-169,403
ember.js,443,2019-10-19 21:00:00,487,-477,964
ember.js,444,2019-10-26 21:00:00,52,-48,100
ember.js,445,2019-11-02 21:00:00,5,-4,9
ember.js,446,2019-11-09 21:00:00,1367,-1203,2570
ember.js,447,2019-11-16 21:00:00,2320,-1573,3893
ember.js,448,2019-11-23 21:00:00,2044,-6021,8065
ember.js,449,2019-11-30 21:00:00,1458,-1245,2703
ember.js,450,2019-12-07 21:00:00,1357,-1608,2965
ember.js,451,2019-12-14 21:00:00,975,-1388,2363
ember.js,452,2019-12-21 21:00:00,22,-17,39
ember.js,453,2019-12-28 21:00:00,95,-67,162
ember.js,454,2020-01-04 21:00:00,294,-283,577
ember.js,455,2020-01-11 21:00:00,193,-196,389
ember.js,456,2020-01-18 21:00:00,497,-193,690
ember.js,457,2020-01-25 21:00:00,1794,-1442,3236
ember.js,458,2020-02-01 21:00:00,2549,-2269,4818
ember.js,459,2020-02-08 21:00:00,352,-117,469
ember.js,460,2020-02-15 21:00:00,217,-64,281
ember.js,461,2020-02-22 21:00:00,1170,-559,1729
ember.js,462,2020-02-29 21:00:00,48,-60,108
ember.js,463,2020-03-07 21:00:00,179,-244,423
ember.js,464,2020-03-14 21:00:00,1200,-977,2177
ember.js,465,2020-03-21 21:00:00,496,-449,945
ember.js,466,2020-03-28 21:00:00,419,-179,598
ember.js,467,2020-04-04 21:00:00,666,-354,1020
ember.js,468,2020-04-11 21:00:00,567,-430,997
ember.js,469,2020-04-18 21:00:00,1796,-1852,3648
ember.js,470,2020-04-25 21:00:00,378,-279,657
ember.js,471,2020-05-02 21:00:00,661,-310,971
ember.js,472,2020-05-09 21:00:00,73,-69,142
ember.js,473,2020-05-16 21:00:00,349,-120,469
ember.js,474,2020-05-23 21:00:00,172,-101,273
ember.js,475,2020-05-30 21:00:00,10,-22,32
ember.js,476,2020-06-06 21:00:00,51,-1,52
ember.js,477,2020-06-13 21:00:00,107,-2,109
ember.js,478,2020-06-20 21:00:00,534,-475,1009
ember.js,479,2020-06-27 21:00:00,6,-2,8
ember.js,480,2020-07-04 21:00:00,506,-746,1252
ember.js,481,2020-07-11 21:00:00,183,-169,352
ember.js,482,2020-07-18 21:00:00,38,-27,65
ember.js,483,2020-07-25 21:00:00,1467,-1080,2547
ember.js,484,2020-08-01 21:00:00,912,-1098,2010
ember.js,485,2020-08-08 21:00:00,1527,-1717,3244
ember.js,486,2020-08-15 21:00:00,265,-323,588
ember.js,487,2020-08-22 21:00:00,478,-76,554
ember.js,488,2020-08-29 21:00:00,553,-429,982
ember.js,489,2020-09-05 21:00:00,339,-4081,4420
ember.js,490,2020-09-12 21:00:00,0,0,0
ember.js,491,2020-09-19 21:00:00,1176,-986,2162
ember.js,492,2020-09-26 21:00:00,7004,-4331,11335
ember.js,493,2020-10-03 21:00:00,388,-276,664
ember.js,494,2020-10-10 21:00:00,822,-2509,3331
ember.js,495,2020-10-17 21:00:00,1468,-143,1611
ember.js,496,2020-10-24 21:00:00,912,-1437,2349
ember.js,497,2020-10-31 21:00:00,603,-878,1481
ember.js,498,2020-11-07 21:00:00,1642,-886,2528
ember.js,499,2020-11-14 21:00:00,514,-285,799
ember.js,500,2020-11-21 21:00:00,1103,-2184,3287
ember.js,501,2020-11-28 21:00:00,205,-193,398
ember.js,502,2020-12-05 21:00:00,689,-225,914
ember.js,503,2020-12-12 21:00:00,1367,-2882,4249
ember.js,504,2020-12-19 21:00:00,201,-157,358
ember.js,505,2020-12-26 21:00:00,83,-52,135
ember.js,506,2021-01-02 21:00:00,1,-2,3
ember.js,507,2021-01-09 21:00:00,123,-3,126
ember.js,508,2021-01-16 21:00:00,1510,-938,2448
ember.js,509,2021-01-23 21:00:00,1498,-1352,2850
ember.js,510,2021-01-30 21:00:00,3146,-1636,4782
ember.js,511,2021-02-06 21:00:00,2612,-1641,4253
ember.js,512,2021-02-13 21:00:00,5364,-4024,9388
ember.js,513,2021-02-20 21:00:00,1216,-420,1636
ember.js,514,2021-02-27 21:00:00,626,-232,858
ember.js,515,2021-03-06 21:00:00,268,-200,468
ember.js,516,2021-03-13 21:00:00,1422,-917,2339
ember.js,517,2021-03-20 21:00:00,1222,-1131,2353
ember.js,518,2021-03-27 21:00:00,422,-15,437
ember.js,519,2021-04-03 21:00:00,383,-238,621
ember.js,520,2021-04-10 21:00:00,0,0,0
ember.js,521,2021-04-17 21:00:00,331,-170,501
ember.js,522,2021-04-24 21:00:00,1532,-984,2516
ember.js,523,2021-05-01 21:00:00,96,-1995,2091
ember.js,524,2021-05-08 21:00:00,543,-243,786
ember.js,525,2021-05-15 21:00:00,224,-472,696
ember.js,526,2021-05-22 21:00:00,1180,-1550,2730
ember.js,527,2021-05-29 21:00:00,2343,-1139,3482
ember.js,528,2021-06-05 21:00:00,106,-11,117
ember.js,529,2021-06-12 21:00:00,5,-1,6
ember.js,530,2021-06-19 21:00:00,15,-11,26
ember.js,531,2021-06-26 21:00:00,60,-32,92
ember.js,532,2021-07-03 21:00:00,20,-1,21
ember.js,533,2021-07-10 21:00:00,86,-3149,3235
ember.js,534,2021-07-17 21:00:00,764,-8259,9023
ember.js,535,2021-07-24 21:00:00,274,-1273,1547
ember.js,536,2021-07-31 21:00:00,205,-894,1099
ember.js,537,2021-08-07 21:00:00,10,-33,43
ember.js,538,2021-08-14 21:00:00,238,-1050,1288
ember.js,539,2021-08-21 21:00:00,113,-238,351
react,136,2016-01-02 21:00:00,457,-275,732
react,137,2016-01-09 21:00:00,475,-559,1034
react,138,2016-01-16 21:00:00,166,-169,335
react,139,2016-01-23 21:00:00,214,-64,278
react,140,2016-01-30 21:00:00,70,-16,86
react,141,2016-02-06 21:00:00,556,-125,681
react,142,2016-02-13 21:00:00,668,-449,1117
react,143,2016-02-20 21:00:00,317,-220,537
react,144,2016-02-27 21:00:00,709,-395,1104
react,145,2016-03-05 21:00:00,1545,-1429,2974
react,146,2016-03-12 21:00:00,1175,-231,1406
react,147,2016-03-19 21:00:00,6104,-8354,14458
react,148,2016-03-26 21:00:00,1446,-2185,3631
react,149,2016-04-02 21:00:00,5848,-4449,10297
react,150,2016-04-09 21:00:00,886,-180,1066
react,151,2016-04-16 21:00:00,5078,-3515,8593
react,152,2016-04-23 21:00:00,6124,-3257,9381
react,153,2016-04-30 21:00:00,3806,-3221,7027
react,154,2016-05-07 21:00:00,17349,-15580,32929
react,155,2016-05-14 21:00:00,7901,-7348,15249
react,156,2016-05-21 21:00:00,9318,-4140,13458
react,157,2016-05-28 21:00:00,1535,-412,1947
react,158,2016-06-04 21:00:00,1493,-609,2102
react,159,2016-06-11 21:00:00,1300,-684,1984
react,160,2016-06-18 21:00:00,736,-375,1111
react,161,2016-06-25 21:00:00,4583,-3133,7716
react,162,2016-07-02 21:00:00,3266,-2109,5375
react,163,2016-07-09 21:00:00,16618,-13981,30599
react,164,2016-07-16 21:00:00,3820,-2114,5934
react,165,2016-07-23 21:00:00,7242,-6353,13595
react,166,2016-07-30 21:00:00,912,-436,1348
react,167,2016-08-06 21:00:00,2220,-1858,4078
react,168,2016-08-13 21:00:00,1696,-1534,3230
react,169,2016-08-20 21:00:00,1005,-439,1444
react,170,2016-08-27 21:00:00,2365,-2345,4710
react,171,2016-09-03 21:00:00,2424,-2383,4807
react,172,2016-09-10 21:00:00,1434,-637,2071
react,173,2016-09-17 21:00:00,1399,-571,1970
react,174,2016-09-24 21:00:00,1218,-174,1392
react,175,2016-10-01 21:00:00,1418,-589,2007
react,176,2016-10-08 21:00:00,8477,-417,8894
react,177,2016-10-15 21:00:00,10468,-30031,40499
react,178,2016-10-22 21:00:00,31315,-23059,54374
react,179,2016-10-29 21:00:00,5253,-2967,8220
react,180,2016-11-05 21:00:00,3332,-1417,4749
react,181,2016-11-12 21:00:00,28084,-24604,52688
react,182,2016-11-19 21:00:00,2713,-1825,4538
react,183,2016-11-26 21:00:00,14850,-12531,27381
react,184,2016-12-03 21:00:00,4377,-1791,6168
react,185,2016-12-10 21:00:00,4061,-2315,6376
react,186,2016-12-17 21:00:00,25680,-1863,27543
react,187,2016-12-24 21:00:00,807,-450,1257
react,188,2016-12-31 21:00:00,12984,-30626,43610
react,189,2017-01-07 21:00:00,4842,-2343,7185
react,190,2017-01-14 21:00:00,1086,-519,1605
react,191,2017-01-21 21:00:00,544,-290,834
react,192,2017-01-28 21:00:00,862,-530,1392
react,193,2017-02-04 21:00:00,19685,-18576,38261
react,194,2017-02-11 21:00:00,512,-628,1140
react,195,2017-02-18 21:00:00,2165,-1426,3591
react,196,2017-02-25 21:00:00,9521,-8341,17862
react,197,2017-03-04 21:00:00,2272,-1346,3618
react,198,2017-03-11 21:00:00,13014,-11527,24541
react,199,2017-03-18 21:00:00,3130,-7080,10210
react,200,2017-03-25 21:00:00,2693,-520,3213
react,201,2017-04-01 21:00:00,17234,-15096,32330
react,202,2017-04-08 21:00:00,1441,-1791,3232
react,203,2017-04-15 21:00:00,4598,-3179,7777
react,204,2017-04-22 21:00:00,7217,-33141,40358
react,205,2017-04-29 21:00:00,1625,-536,2161
react,206,2017-05-06 21:00:00,15802,-18920,34722
react,207,2017-05-13 21:00:00,1812,-858,2670
react,208,2017-05-20 21:00:00,2439,-1334,3773
react,209,2017-05-27 21:00:00,1107,-2567,3674
react,210,2017-06-03 21:00:00,1492,-2615,4107
react,211,2017-06-10 21:00:00,5198,-5591,10789
react,212,2017-06-17 21:00:00,2185,-2060,4245
react,213,2017-06-24 21:00:00,1503,-480,1983
react,214,2017-07-01 21:00:00,26,-14,40
react,215,2017-07-08 21:00:00,1935,-1226,3161
react,216,2017-07-15 21:00:00,3493,-2559,6052
react,217,2017-07-22 21:00:00,1088,-650,1738
react,218,2017-07-29 21:00:00,4472,-2772,7244
react,219,2017-08-05 21:00:00,6061,-3388,9449
react,220,2017-08-12 21:00:00,2029,-1103,3132
react,221,2017-08-19 21:00:00,44366,-37864,82230
react,222,2017-08-26 21:00:00,4634,-3620,8254
react,223,2017-09-02 21:00:00,14614,-230,14844
react,224,2017-09-09 21:00:00,880,-829,1709
react,225,2017-09-16 21:00:00,104,-5,109
react,226,2017-09-23 21:00:00,24669,-18833,43502
react,227,2017-09-30 21:00:00,2710,-61728,64438
react,228,2017-10-07 21:00:00,4238,-2554,6792
react,229,2017-10-14 21:00:00,159778,-146002,305780
react,230,2017-10-21 21:00:00,4014,-4324,8338
react,231,2017-10-28 21:00:00,7621,-6297,13918
react,232,2017-11-04 21:00:00,6146,-4985,11131
react,233,2017-11-11 21:00:00,7478,-344,7822
react,234,2017-11-18 21:00:00,18811,-15839,34650
react,235,2017-11-25 21:00:00,6810,-9534,16344
react,236,2017-12-02 21:00:00,4652,-3863,8515
react,237,2017-12-09 21:00:00,11126,-7079,18205
react,238,2017-12-16 21:00:00,340,-128,468
react,239,2017-12-23 21:00:00,111,-100,211
react,240,2017-12-30 21:00:00,4396,-5582,9978
react,241,2018-01-06 21:00:00,1390,-760,2150
react,242,2018-01-13 21:00:00,2740,-1582,4322
react,243,2018-01-20 21:00:00,11881,-8684,20565
react,244,2018-01-27 21:00:00,3041,-1574,4615
react,245,2018-02-03 21:00:00,1223,-414,1637
react,246,2018-02-10 21:00:00,1307,-102,1409
react,247,2018-02-17 21:00:00,6095,-4912,11007
react,248,2018-02-24 21:00:00,208,-142,350
react,249,2018-03-03 21:00:00,6,-3,9
react,250,2018-03-10 21:00:00,2668,-813,3481
react,251,2018-03-17 21:00:00,844,-659,1503
react,252,2018-03-24 21:00:00,2150,-963,3113
react,253,2018-03-31 21:00:00,989,-609,1598
react,254,2018-04-07 21:00:00,1247,-1180,2427
react,255,2018-04-14 21:00:00,1547,-905,2452
react,256,2018-04-21 21:00:00,1836,-1157,2993
react,257,2018-04-28 21:00:00,36,-13,49
react,258,2018-05-05 21:00:00,3725,-364,4089
react,259,2018-05-12 21:00:00,15048,-13697,28745
react,260,2018-05-19 21:00:00,2023,-749,2772
react,261,2018-05-26 21:00:00,1880,-1226,3106
react,262,2018-06-02 21:00:00,68,-36,104
react,263,2018-06-09 21:00:00,2672,-1704,4376
react,264,2018-06-16 21:00:00,1211,-377,1588
react,265,2018-06-23 21:00:00,217,-56,273
react,266,2018-06-30 21:00:00,2873,-1850,4723
react,267,2018-07-07 21:00:00,1202,-582,1784
react,268,2018-07-14 21:00:00,4087,-2648,6735
react,269,2018-07-21 21:00:00,144,-95,239
react,270,2018-07-28 21:00:00,34030,-16673,50703
react,271,2018-08-04 21:00:00,903,-1430,2333
react,272,2018-08-11 21:00:00,5747,-2324,8071
react,273,2018-08-18 21:00:00,724,-409,1133
react,274,2018-08-25 21:00:00,5823,-3450,9273
react,275,2018-09-01 21:00:00,10844,-8086,18930
react,276,2018-09-08 21:00:00,5840,-4511,10351
react,277,2018-09-15 21:00:00,4669,-4629,9298
react,278,2018-09-22 21:00:00,6803,-1469,8272
react,279,2018-09-29 21:00:00,5642,-3856,9498
react,280,2018-10-06 21:00:00,2078,-1038,3116
react,281,2018-10-13 21:00:00,4867,-2245,7112
react,282,2018-10-20 21:00:00,2991,-1284,4275
react,283,2018-10-27 21:00:00,2567,-2688,5255
react,284,2018-11-03 21:00:00,5902,-2491,8393
react,285,2018-11-10 21:00:00,374,-224,598
react,286,2018-11-17 21:00:00,3540,-1775,5315
react,287,2018-11-24 21:00:00,3218,-470,3688
react,288,2018-12-01 21:00:00,2119,-1023,3142
react,289,2018-12-08 21:00:00,308,-217,525
react,290,2018-12-15 21:00:00,81,-33,114
react,291,2018-12-22 21:00:00,1,-1,2
react,292,2018-12-29 21:00:00,4,-4,8
react,293,2019-01-05 21:00:00,241,-140,381
react,294,2019-01-12 21:00:00,3712,-423,4135
react,295,2019-01-19 21:00:00,18445,-2774,21219
react,296,2019-01-26 21:00:00,3593,-2339,5932
react,297,2019-02-02 21:00:00,6550,-2340,8890
react,298,2019-02-09 21:00:00,4204,-1193,5397
react,299,2019-02-16 21:00:00,5449,-1117,6566
react,300,2019-02-23 21:00:00,10074,-7029,17103
react,301,2019-03-02 21:00:00,6313,-3951,10264
react,302,2019-03-09 21:00:00,9155,-3040,12195
react,303,2019-03-16 21:00:00,7972,-4308,12280
react,304,2019-03-23 21:00:00,4889,-10145,15034
react,305,2019-03-30 21:00:00,17539,-7542,25081
react,306,2019-04-06 21:00:00,15691,-14140,29831
react,307,2019-04-13 21:00:00,11328,-3970,15298
react,308,2019-04-20 21:00:00,8130,-3483,11613
react,309,2019-04-27 21:00:00,5654,-2308,7962
react,310,2019-05-04 21:00:00,8203,-3322,11525
react,311,2019-05-11 21:00:00,23066,-18551,41617
react,312,2019-05-18 21:00:00,15801,-12168,27969
react,313,2019-05-25 21:00:00,4711,-2207,6918
react,314,2019-06-01 21:00:00,13586,-2512,16098
react,315,2019-06-08 21:00:00,11409,-9559,20968
react,316,2019-06-15 21:00:00,8069,-2514,10583
react,317,2019-06-22 21:00:00,13479,-11848,25327
react,318,2019-06-29 21:00:00,2428,-2519,4947
react,319,2019-07-06 21:00:00,5782,-2143,7925
react,320,2019-07-13 21:00:00,6469,-1350,7819
react,321,2019-07-20 21:00:00,14804,-13167,27971
react,322,2019-07-27 21:00:00,3990,-4650,8640
react,323,2019-08-03 21:00:00,4928,-2805,7733
react,324,2019-08-10 21:00:00,151504,-156472,307976
react,325,2019-08-17 21:00:00,4463,-2907,7370
react,326,2019-08-24 21:00:00,69713,-65327,135040
react,327,2019-08-31 21:00:00,3529,-1228,4757
react,328,2019-09-07 21:00:00,5093,-2851,7944
react,329,2019-09-14 21:00:00,30639,-28725,59364
react,330,2019-09-21 21:00:00,5120,-1664,6784
react,331,2019-09-28 21:00:00,3902,-2593,6495
react,332,2019-10-05 21:00:00,881,-1550,2431
react,333,2019-10-12 21:00:00,3977,-2780,6757
react,334,2019-10-19 21:00:00,251,-187,438
react,335,2019-10-26 21:00:00,4920,-4053,8973
react,336,2019-11-02 21:00:00,12159,-1092,13251
react,337,2019-11-09 21:00:00,2584,-1658,4242
react,338,2019-11-16 21:00:00,8383,-7978,16361
react,339,2019-11-23 21:00:00,249,-166,415
react,340,2019-11-30 21:00:00,1767,-1019,2786
react,341,2019-12-07 21:00:00,5032,-4336,9368
react,342,2019-12-14 21:00:00,8516,-7280,15796
react,343,2019-12-21 21:00:00,62,-23,85
react,344,2019-12-28 21:00:00,719,-304,1023
react,345,2020-01-04 21:00:00,3717,-2858,6575
react,346,2020-01-11 21:00:00,1067,-3138,4205
react,347,2020-01-18 21:00:00,3495,-4146,7641
react,348,2020-01-25 21:00:00,926,-363,1289
react,349,2020-02-01 21:00:00,1583,-1235,2818
react,350,2020-02-08 21:00:00,2194,-2715,4909
react,351,2020-02-15 21:00:00,11887,-9118,21005
react,352,2020-02-22 21:00:00,2925,-3501,6426
react,353,2020-02-29 21:00:00,7366,-3091,10457
react,354,2020-03-07 21:00:00,11484,-7897,19381
react,355,2020-03-14 21:00:00,6592,-3639,10231
react,356,2020-03-21 21:00:00,4094,-2421,6515
react,357,2020-03-28 21:00:00,10608,-9972,20580
react,358,2020-04-04 21:00:00,67981,-42169,110150
react,359,2020-04-11 21:00:00,28327,-20580,48907
react,360,2020-04-18 21:00:00,4756,-7615,12371
react,361,2020-04-25 21:00:00,15827,-3563,19390
react,362,2020-05-02 21:00:00,8050,-3500,11550
react,363,2020-05-09 21:00:00,5470,-914,6384
react,364,2020-05-16 21:00:00,2138,-627,2765
react,365,2020-05-23 21:00:00,3578,-3374,6952
react,366,2020-05-30 21:00:00,145,-51,196
react,367,2020-06-06 21:00:00,2484,-3837,6321
react,368,2020-06-13 21:00:00,683,-585,1268
react,369,2020-06-20 21:00:00,613,-166,779
react,370,2020-06-27 21:00:00,11714,-18517,30231
react,371,2020-07-04 21:00:00,4752,-3646,8398
react,372,2020-07-11 21:00:00,2645,-1495,4140
react,373,2020-07-18 21:00:00,8012,-7278,15290
react,374,2020-07-25 21:00:00,5907,-2390,8297
react,375,2020-08-01 21:00:00,1667,-12714,14381
react,376,2020-08-08 21:00:00,4982,-3564,8546
react,377,2020-08-15 21:00:00,11408,-1349,12757
react,378,2020-08-22 21:00:00,3047,-2628,5675
react,379,2020-08-29 21:00:00,5290,-3919,9209
react,380,2020-09-05 21:00:00,1023,-426,1449
react,381,2020-09-12 21:00:00,6512,-2914,9426
react,382,2020-09-19 21:00:00,2775,-1509,4284
react,383,2020-09-26 21:00:00,1036,-478,1514
react,384,2020-10-03 21:00:00,684,-707,1391
react,385,2020-10-10 21:00:00,17146,-410,17556
react,386,2020-10-17 21:00:00,1019,-242,1261
react,387,2020-10-24 21:00:00,2083,-2408,4491
react,388,2020-10-31 21:00:00,3822,-2253,6075
react,389,2020-11-07 21:00:00,4909,-4618,9527
react,390,2020-11-14 21:00:00,1451,-420,1871
react,391,2020-11-21 21:00:00,0,0,0
react,392,2020-11-28 21:00:00,3519,-1379,4898
react,393,2020-12-05 21:00:00,16844,-10169,27013
react,394,2020-12-12 21:00:00,2589,-183,2772
react,395,2020-12-19 21:00:00,4635,-1829,6464
react,396,2020-12-26 21:00:00,0,0,0
react,397,2021-01-02 21:00:00,51,-17,68
react,398,2021-01-09 21:00:00,1118,-829,1947
react,399,2021-01-16 21:00:00,6750,-6010,12760
react,400,2021-01-23 21:00:00,2256,-983,3239
react,401,2021-01-30 21:00:00,1426,-1978,3404
react,402,2021-02-06 21:00:00,3026,-1948,4974
react,403,2021-02-13 21:00:00,418,-156,574
react,404,2021-02-20 21:00:00,4302,-3850,8152
react,405,2021-02-27 21:00:00,1105,-1040,2145
react,406,2021-03-06 21:00:00,5346,-3110,8456
react,407,2021-03-13 21:00:00,2203,-1242,3445
react,408,2021-03-20 21:00:00,2978,-1821,4799
react,409,2021-03-27 21:00:00,2869,-1505,4374
react,410,2021-04-03 21:00:00,10098,-1872,11970
react,411,2021-04-10 21:00:00,2606,-476,3082
react,412,2021-04-17 21:00:00,5061,-3030,8091
react,413,2021-04-24 21:00:00,7558,-13270,20828
react,414,2021-05-01 21:00:00,1602,-1366,2968
react,415,2021-05-08 21:00:00,1482,-3060,4542
react,416,2021-05-15 21:00:00,2715,-3387,6102
react,417,2021-05-22 21:00:00,1059,-967,2026
react,418,2021-05-29 21:00:00,15422,-849,16271
react,419,2021-06-05 21:00:00,390,-163,553
react,420,2021-06-12 21:00:00,25907,-25704,51611
react,421,2021-06-19 21:00:00,3179,-2725,5904
react,422,2021-06-26 21:00:00,3276,-633,3909
react,423,2021-07-03 21:00:00,2630,-1556,4186
react,424,2021-07-10 21:00:00,3005,-1467,4472
react,425,2021-07-17 21:00:00,1994,-2162,4156
react,426,2021-07-24 21:00:00,3693,-1946,5639
react,427,2021-07-31 21:00:00,7652,-3538,11190
react,428,2021-08-07 21:00:00,6794,-1569,8363
react,429,2021-08-14 21:00:00,5631,-1250,6881
react,430,2021-08-21 21:00:00,3435,-1253,4688
swift,285,2016-01-02 21:00:00,41023,-27433,68456
swift,286,2016-01-09 21:00:00,17021,-10903,27924
swift,287,2016-01-16 21:00:00,33741,-51498,85239
swift,288,2016-01-23 21:00:00,29288,-25373,54661
swift,289,2016-01-30 21:00:00,21526,-16562,38088
swift,290,2016-02-06 21:00:00,26009,-13478,39487
swift,291,2016-02-13 21:00:00,21464,-14681,36145
swift,292,2016-02-20 21:00:00,30974,-18251,49225
swift,293,2016-02-27 21:00:00,16863,-10863,27726
swift,294,2016-03-05 21:00:00,59879,-39452,99331
swift,295,2016-03-12 21:00:00,32929,-22973,55902
swift,296,2016-03-19 21:00:00,34181,-20365,54546
swift,297,2016-03-26 21:00:00,31691,-17350,49041
swift,298,2016-04-02 21:00:00,32004,-22090,54094
swift,299,2016-04-09 21:00:00,16987,-11133,28120
swift,300,2016-04-16 21:00:00,28495,-26602,55097
swift,301,2016-04-23 21:00:00,17923,-13505,31428
swift,302,2016-04-30 21:00:00,17123,-8101,25224
swift,303,2016-05-07 21:00:00,14046,-5452,19498
swift,304,2016-05-14 21:00:00,9239,-6017,15256
swift,305,2016-05-21 21:00:00,8644,-4813,13457
swift,306,2016-05-28 21:00:00,8831,-5036,13867
swift,307,2016-06-04 21:00:00,9457,-6169,15626
swift,308,2016-06-11 21:00:00,36164,-16643,52807
swift,309,2016-06-18 21:00:00,14166,-10769,24935
swift,310,2016-06-25 21:00:00,11530,-6335,17865
swift,311,2016-07-02 21:00:00,15367,-7748,23115
swift,312,2016-07-09 21:00:00,23227,-20823,44050
swift,313,2016-07-16 21:00:00,20298,-14398,34696
swift,314,2016-07-23 21:00:00,28469,-16394,44863
swift,315,2016-07-30 21:00:00,12304,-5198,17502
swift,316,2016-08-06 21:00:00,15783,-9961,25744
swift,317,2016-08-13 21:00:00,8256,-5573,13829
swift,318,2016-08-20 21:00:00,7711,-4431,12142
swift,319,2016-08-27 21:00:00,38980,-34600,73580
swift,320,2016-09-03 21:00:00,15096,-11764,26860
swift,321,2016-09-10 21:00:00,12794,-10258,23052
swift,322,2016-09-17 21:00:00,11293,-6376,17669
swift,323,2016-09-24 21:00:00,9947,-6741,16688
swift,324,2016-10-01 21:00:00,7393,-4851,12244
swift,325,2016-10-08 21:00:00,111267,-5404,116671
swift,326,2016-10-15 21:00:00,8778,-6198,14976
swift,327,2016-10-22 21:00:00,13258,-8516,21774
swift,328,2016-10-29 21:00:00,19905,-14991,34896
swift,329,2016-11-05 21:00:00,10374,-5580,15954
swift,330,2016-11-12 21:00:00,14576,-13028,27604
swift,331,2016-11-19 21:00:00,17364,-16754,34118
swift,332,2016-11-26 21:00:00,17708,-8366,26074
swift,333,2016-12-03 21:00:00,11330,-7392,18722
swift,334,2016-12-10 21:00:00,30104,-9424,39528
swift,335,2016-12-17 21:00:00,10639,-4599,15238
swift,336,2016-12-24 21:00:00,3138,-1922,5060
swift,337,2016-12-31 21:00:00,21931,-17378,39309
swift,338,2017-01-07 21:00:00,25318,-6951,32269
swift,339,2017-01-14 21:00:00,10179,-3225,13404
swift,340,2017-01-21 21:00:00,28635,-15759,44394
swift,341,2017-01-28 21:00:00,9888,-4359,14247
swift,342,2017-02-04 21:00:00,14344,-9502,23846
swift,343,2017-02-11 21:00:00,16201,-7466,23667
swift,344,2017-02-18 21:00:00,18780,-8865,27645
swift,345,2017-02-25 21:00:00,14673,-7598,22271
swift,346,2017-03-04 21:00:00,26768,-19424,46192
swift,347,2017-03-11 21:00:00,13439,-12076,25515
swift,348,2017-03-18 21:00:00,17921,-105979,123900
swift,349,2017-03-25 21:00:00,18235,-9545,27780
swift,350,2017-04-01 21:00:00,14472,-8531,23003
swift,351,2017-04-08 21:00:00,20902,-8637,29539
swift,352,2017-04-15 21:00:00,38567,-9579,48146
swift,353,2017-04-22 21:00:00,59550,-7503,67053
swift,354,2017-04-29 21:00:00,60098,-31704,91802
swift,355,2017-05-06 21:00:00,14881,-8106,22987
swift,356,2017-05-13 21:00:00,24894,-13698,38592
swift,357,2017-05-20 21:00:00,9711,-4433,14144
swift,358,2017-05-27 21:00:00,18157,-7022,25179
swift,359,2017-06-03 21:00:00,5443,-2852,8295
swift,360,2017-06-10 21:00:00,17425,-5619,23044
swift,361,2017-06-17 21:00:00,12286,-7402,19688
swift,362,2017-06-24 21:00:00,16045,-10390,26435
swift,363,2017-07-01 21:00:00,9463,-13349,22812
swift,364,2017-07-08 21:00:00,20297,-12692,32989
swift,365,2017-07-15 21:00:00,11710,-8573,20283
swift,366,2017-07-22 21:00:00,13992,-11731,25723
swift,367,2017-07-29 21:00:00,10732,-8179,18911
swift,368,2017-08-05 21:00:00,4343,-3923,8266
swift,369,2017-08-12 21:00:00,10379,-3253,13632
swift,370,2017-08-19 21:00:00,24384,-5751,30135
swift,371,2017-08-26 21:00:00,9242,-6122,15364
swift,372,2017-09-02 21:00:00,11119,-5911,17030
swift,373,2017-09-09 21:00:00,24800,-9452,34252
swift,374,2017-09-16 21:00:00,16908,-12532,29440
swift,375,2017-09-23 21:00:00,6747,-3328,10075
swift,376,2017-09-30 21:00:00,15472,-8862,24334
swift,377,2017-10-07 21:00:00,11047,-7559,18606
swift,378,2017-10-14 21:00:00,10393,-5091,15484
swift,379,2017-10-21 21:00:00,7356,-4135,11491
swift,380,2017-10-28 21:00:00,8342,-5327,13669
swift,381,2017-11-04 21:00:00,22557,-18802,41359
swift,382,2017-11-11 21:00:00,10951,-7846,18797
swift,383,2017-11-18 21:00:00,2105,-2034,4139
swift,384,2017-11-25 21:00:00,17337,-14611,31948
swift,385,2017-12-02 21:00:00,10491,-7596,18087
swift,386,2017-12-09 21:00:00,18476,-12823,31299
swift,387,2017-12-16 21:00:00,13665,-8942,22607
swift,388,2017-12-23 21:00:00,2785,-2067,4852
swift,389,2017-12-30 21:00:00,24403,-19113,43516
swift,390,2018-01-06 21:00:00,17827,-11765,29592
swift,391,2018-01-13 21:00:00,9358,-6525,15883
swift,392,2018-01-20 21:00:00,13155,-6690,19845
swift,393,2018-01-27 21:00:00,14607,-11335,25942
swift,394,2018-02-03 21:00:00,13395,-6762,20157
swift,395,2018-02-10 21:00:00,12008,-9536,21544
swift,396,2018-02-17 21:00:00,11197,-5069,16266
swift,397,2018-02-24 21:00:00,13709,-6013,19722
swift,398,2018-03-03 21:00:00,58904,-9466,68370
swift,399,2018-03-10 21:00:00,18066,-57616,75682
swift,400,2018-03-17 21:00:00,31112,-21031,52143
swift,401,2018-03-24 21:00:00,89259,-82291,171550
swift,402,2018-03-31 21:00:00,16776,-76294,93070
swift,403,2018-04-07 21:00:00,28425,-12567,40992
swift,404,2018-04-14 21:00:00,13014,-8214,21228
swift,405,2018-04-21 21:00:00,11024,-7093,18117
swift,406,2018-04-28 21:00:00,14217,-10201,24418
swift,407,2018-05-05 21:00:00,10672,-6139,16811
swift,408,2018-05-12 21:00:00,8361,-5235,13596
swift,409,2018-05-19 21:00:00,16075,-9203,25278
swift,410,2018-05-26 21:00:00,11897,-6057,17954
swift,411,2018-06-02 21:00:00,14758,-5555,20313
swift,412,2018-06-09 21:00:00,12604,-10005,22609
swift,413,2018-06-16 21:00:00,11509,-2560,14069
swift,414,2018-06-23 21:00:00,17052,-11629,28681
swift,415,2018-06-30 21:00:00,24597,-15830,40427
swift,416,2018-07-07 21:00:00,9329,-6196,15525
swift,417,2018-07-14 21:00:00,16928,-17409,34337
swift,418,2018-07-21 21:00:00,21880,-14480,36360
swift,419,2018-07-28 21:00:00,96634,-67674,164308
swift,420,2018-08-04 21:00:00,10957,-6989,17946
swift,421,2018-08-11 21:00:00,21088,-19397,40485
swift,422,2018-08-18 21:00:00,17155,-14968,32123
swift,423,2018-08-25 21:00:00,24740,-25917,50657
swift,424,2018-09-01 21:00:00,9368,-5946,15314
swift,425,2018-09-08 21:00:00,9634,-7390,17024
swift,426,2018-09-15 21:00:00,29713,-26078,55791
swift,427,2018-09-22 21:00:00,21405,-17203,38608
swift,428,2018-09-29 21:00:00,487436,-222780,710216
swift,429,2018-10-06 21:00:00,29266,-7983,37249
swift,430,2018-10-13 21:00:00,5565,-3402,8967
swift,431,2018-10-20 21:00:00,74249,-17717,91966
swift,432,2018-10-27 21:00:00,45836,-59088,104924
swift,433,2018-11-03 21:00:00,17154,-8312,25466
swift,434,2018-11-10 21:00:00,14092,-9393,23485
swift,435,2018-11-17 21:00:00,4452,-2379,6831
swift,436,2018-11-24 21:00:00,57085,-51625,108710
swift,437,2018-12-01 21:00:00,23979,-16595,40574
swift,438,2018-12-08 21:00:00,110949,-92231,203180
swift,439,2018-12-15 21:00:00,11672,-7732,19404
swift,440,2018-12-22 21:00:00,1084,-381,1465
swift,441,2018-12-29 21:00:00,6398,-4753,11151
swift,442,2019-01-05 21:00:00,9459,-4388,13847
swift,443,2019-01-12 21:00:00,9804,-4633,14437
swift,444,2019-01-19 21:00:00,11925,-3457,15382
swift,445,2019-01-26 21:00:00,8393,-3412,11805
swift,446,2019-02-02 21:00:00,14280,-5535,19815
swift,447,2019-02-09 21:00:00,10381,-5643,16024
swift,448,2019-02-16 21:00:00,19655,-12094,31749
swift,449,2019-02-23 21:00:00,13965,-8480,22445
swift,450,2019-03-02 21:00:00,13877,-6730,20607
swift,451,2019-03-09 21:00:00,18808,-4854,23662
swift,452,2019-03-16 21:00:00,13469,-5015,18484
swift,453,2019-03-23 21:00:00,15973,-10349,26322
swift,454,2019-03-30 21:00:00,290914,-269483,560397
swift,455,2019-04-06 21:00:00,10784,-5781,16565
swift,456,2019-04-13 21:00:00,19189,-7961,27150
swift,457,2019-04-20 21:00:00,16761,-5207,21968
swift,458,2019-04-27 21:00:00,7982,-3860,11842
swift,459,2019-05-04 21:00:00,6569,-3736,10305
swift,460,2019-05-11 21:00:00,7805,-4665,12470
swift,461,2019-05-18 21:00:00,8191,-4627,12818
swift,462,2019-05-25 21:00:00,16433,-9897,26330
swift,463,2019-06-01 21:00:00,5355,-3474,8829
swift,464,2019-06-08 21:00:00,12724,-6039,18763
swift,465,2019-06-15 21:00:00,7627,-3364,10991
swift,466,2019-06-22 21:00:00,104922,-40657,145579
swift,467,2019-06-29 21:00:00,4728,-2551,7279
swift,468,2019-07-06 21:00:00,10102,-6989,17091
swift,469,2019-07-13 21:00:00,8528,-5904,14432
swift,470,2019-07-20 21:00:00,11472,-8771,20243
swift,471,2019-07-27 21:00:00,10306,-5838,16144
swift,472,2019-08-03 21:00:00,11635,-8208,19843
swift,473,2019-08-10 21:00:00,13900,-11324,25224
swift,474,2019-08-17 21:00:00,8051,-5868,13919
swift,475,2019-08-24 21:00:00,550367,-552822,1103189
swift,476,2019-08-31 21:00:00,1012026,-1015063,2027089
swift,477,2019-09-07 21:00:00,17168,-14693,31861
swift,478,2019-09-14 21:00:00,12136,-7015,19151
swift,479,2019-09-21 21:00:00,21153,-12073,33226
swift,480,2019-09-28 21:00:00,11430,-6407,17837
swift,481,2019-10-05 21:00:00,7488,-5512,13000
swift,482,2019-10-12 21:00:00,16462,-16017,32479
swift,483,2019-10-19 21:00:00,9531,-6422,15953
swift,484,2019-10-26 21:00:00,13008,-9142,22150
swift,485,2019-11-02 21:00:00,14737,-9603,24340
swift,486,2019-11-09 21:00:00,14932,-7051,21983
swift,487,2019-11-16 21:00:00,14499,-8675,23174
swift,488,2019-11-23 21:00:00,3674,-3694,7368
swift,489,2019-11-30 21:00:00,14112,-9650,23762
swift,490,2019-12-07 21:00:00,25287,-12232,37519
swift,491,2019-12-14 21:00:00,19969,-8009,27978
swift,492,2019-12-21 21:00:00,2965,-1682,4647
swift,493,2019-12-28 21:00:00,4579,-1650,6229
swift,494,2020-01-04 21:00:00,10539,-6363,16902
swift,495,2020-01-11 21:00:00,28589,-13994,42583
swift,496,2020-01-18 21:00:00,11417,-5012,16429
swift,497,2020-01-25 21:00:00,13285,-3800,17085
swift,498,2020-02-01 21:00:00,17302,-8729,26031
swift,499,2020-02-08 21:00:00,17010,-6700,23710
swift,500,2020-02-15 21:00:00,19623,-15545,35168
swift,501,2020-02-22 21:00:00,309484,-287909,597393
swift,502,2020-02-29 21:00:00,49558,-35317,84875
swift,503,2020-03-07 21:00:00,11550,-6476,18026
swift,504,2020-03-14 21:00:00,8882,-3954,12836
swift,505,2020-03-21 21:00:00,30948,-16179,47127
swift,506,2020-03-28 21:00:00,55935,-45350,101285
swift,507,2020-04-04 21:00:00,25388,-6608,31996
swift,508,2020-04-11 21:00:00,19221,-11540,30761
swift,509,2020-04-18 21:00:00,10755,-4491,15246
swift,510,2020-04-25 21:00:00,12773,-15042,27815
swift,511,2020-05-02 21:00:00,92588,-16347,108935
swift,512,2020-05-09 21:00:00,24243,-67513,91756
swift,513,2020-05-16 21:00:00,9924,-5771,15695
swift,514,2020-05-23 21:00:00,22100,-8356,30456
swift,515,2020-05-30 21:00:00,10701,-4020,14721
swift,516,2020-06-06 21:00:00,12385,-7128,19513
swift,517,2020-06-13 21:00:00,6268,-2723,8991
swift,518,2020-06-20 21:00:00,8047,-49708,57755
swift,519,2020-06-27 21:00:00,30135,-13804,43939
swift,520,2020-07-04 21:00:00,18295,-13378,31673
swift,521,2020-07-11 21:00:00,22010,-15483,37493
swift,522,2020-07-18 21:00:00,8984,-15739,24723
swift,523,2020-07-25 21:00:00,12918,-5180,18098
swift,524,2020-08-01 21:00:00,7428,-3760,11188
swift,525,2020-08-08 21:00:00,14241,-15070,29311
swift,526,2020-08-15 21:00:00,7316,-2286,9602
swift,527,2020-08-22 21:00:00,17549,-17440,34989
swift,528,2020-08-29 21:00:00,7455,-4994,12449
swift,529,2020-09-05 21:00:00,12290,-5117,17407
swift,530,2020-09-12 21:00:00,6477,-2474,8951
swift,531,2020-09-19 21:00:00,18675,-25619,44294
swift,532,2020-09-26 21:00:00,16035,-7066,23101
swift,533,2020-10-03 21:00:00,20067,-15841,35908
swift,534,2020-10-10 21:00:00,8176,-4453,12629
swift,535,2020-10-17 21:00:00,16897,-8332,25229
swift,536,2020-10-24 21:00:00,9814,-5989,15803
swift,537,2020-10-31 21:00:00,8258,-3612,11870
swift,538,2020-11-07 21:00:00,11616,-5530,17146
swift,539,2020-11-14 21:00:00,17646,-9031,26677
swift,540,2020-11-21 21:00:00,6043,-5168,11211
swift,541,2020-11-28 21:00:00,11209,-3752,14961
swift,542,2020-12-05 21:00:00,11684,-4621,16305
swift,543,2020-12-12 21:00:00,9437,-5712,15149
swift,544,2020-12-19 21:00:00,6144,-2307,8451
swift,545,2020-12-26 21:00:00,10941,-1290,12231
swift,546,2021-01-02 21:00:00,14537,-2710,17247
swift,547,2021-01-09 21:00:00,15854,-11109,26963
swift,548,2021-01-16 21:00:00,10569,-6573,17142
swift,549,2021-01-23 21:00:00,15295,-8806,24101
swift,550,2021-01-30 21:00:00,14928,-9250,24178
swift,551,2021-02-06 21:00:00,15844,-6949,22793
swift,552,2021-02-13 21:00:00,16265,-11511,27776
swift,553,2021-02-20 21:00:00,18690,-7654,26344
swift,554,2021-02-27 21:00:00,14316,-8817,23133
swift,555,2021-03-06 21:00:00,77426,-6924,84350
swift,556,2021-03-13 21:00:00,37365,-67495,104860
swift,557,2021-03-20 21:00:00,9928,-4392,14320
swift,558,2021-03-27 21:00:00,14598,-8549,23147
swift,559,2021-04-03 21:00:00,8863,-6109,14972
swift,560,2021-04-10 21:00:00,7627,-3349,10976
swift,561,2021-04-17 21:00:00,10132,-4715,14847
swift,562,2021-04-24 21:00:00,7503,-4092,11595
swift,563,2021-05-01 21:00:00,10573,-4050,14623
swift,564,2021-05-08 21:00:00,14444,-5816,20260
swift,565,2021-05-15 21:00:00,12815,-10201,23016
swift,566,2021-05-22 21:00:00,11989,-3734,15723
swift,567,2021-05-29 21:00:00,7858,-3443,11301
swift,568,2021-06-05 21:00:00,7331,-50523,57854
swift,569,2021-06-12 21:00:00,9724,-5006,14730
swift,570,2021-06-19 21:00:00,7740,-4886,12626
swift,571,2021-06-26 21:00:00,10118,-4367,14485
swift,572,2021-07-03 21:00:00,5156,-851,6007
swift,573,2021-07-10 21:00:00,17151,-11202,28353
swift,574,2021-07-17 21:00:00,6419,-4586,11005
swift,575,2021-07-24 21:00:00,4143,-1789,5932
swift,576,2021-07-31 21:00:00,11272,-5547,16819
swift,577,2021-08-07 21:00:00,4249,-2672,6921
swift,578,2021-08-14 21:00:00,8326,-6843,15169
swift,579,2021-08-21 21:00:00,3754,-2673,6427
guava,329,2016-01-02 21:00:00,1844,-1765,3609
guava,330,2016-01-09 21:00:00,494,-335,829
guava,331,2016-01-16 21:00:00,758,-391,1149
guava,332,2016-01-23 21:00:00,1510,-1816,3326
guava,333,2016-01-30 21:00:00,7170,-6913,14083
guava,334,2016-02-06 21:00:00,1777,-448,2225
guava,335,2016-02-13 21:00:00,7248,-7821,15069
guava,336,2016-02-20 21:00:00,3305,-3060,6365
guava,337,2016-02-27 21:00:00,1811,-557,2368
guava,338,2016-03-05 21:00:00,1231,-743,1974
guava,339,2016-03-12 21:00:00,2511,-4382,6893
guava,340,2016-03-19 21:00:00,3243,-3303,6546
guava,341,2016-03-26 21:00:00,248,-154,402
guava,342,2016-04-02 21:00:00,5280,-3677,8957
guava,343,2016-04-09 21:00:00,252,-109,361
guava,344,2016-04-16 21:00:00,1355,-829,2184
guava,345,2016-04-23 21:00:00,256,-2514,2770
guava,346,2016-04-30 21:00:00,393,-376,769
guava,347,2016-05-07 21:00:00,194,-22,216
guava,348,2016-05-14 21:00:00,70,-41,111
guava,349,2016-05-21 21:00:00,424,-113,537
guava,350,2016-05-28 21:00:00,492,-12,504
guava,351,2016-06-04 21:00:00,686,-131,817
guava,352,2016-06-11 21:00:00,747,-820,1567
guava,353,2016-06-18 21:00:00,1255,-1105,2360
guava,354,2016-06-25 21:00:00,463,-528,991
guava,355,2016-07-02 21:00:00,890,-1413,2303
guava,356,2016-07-09 21:00:00,2099,-2484,4583
guava,357,2016-07-16 21:00:00,471,-1116,1587
guava,358,2016-07-23 21:00:00,470,-182,652
guava,359,2016-07-30 21:00:00,2603,-2125,4728
guava,360,2016-08-06 21:00:00,2339,-1370,3709
guava,361,2016-08-13 21:00:00,5145,-4138,9283
guava,362,2016-08-20 21:00:00,1577,-854,2431
guava,363,2016-08-27 21:00:00,3573,-3311,6884
guava,364,2016-09-03 21:00:00,564,-625,1189
guava,365,2016-09-10 21:00:00,656,-2669,3325
guava,366,2016-09-17 21:00:00,420,-337,757
guava,367,2016-09-24 21:00:00,238,-290,528
guava,368,2016-10-01 21:00:00,124,-2532,2656
guava,369,2016-10-08 21:00:00,357,-102,459
guava,370,2016-10-15 21:00:00,113,-27,140
guava,371,2016-10-22 21:00:00,978,-675,1653
guava,372,2016-10-29 21:00:00,10064,-861,10925
guava,373,2016-11-05 21:00:00,1196,-381,1577
guava,374,2016-11-12 21:00:00,882,-2296,3178
guava,375,2016-11-19 21:00:00,78,0,78
guava,376,2016-11-26 21:00:00,156,-16,172
guava,377,2016-12-03 21:00:00,297,-111,408
guava,378,2016-12-10 21:00:00,683,-69,752
guava,379,2016-12-17 21:00:00,283,-108,391
guava,380,2016-12-24 21:00:00,123,-103,226
guava,381,2016-12-31 21:00:00,430,-84,514
guava,382,2017-01-07 21:00:00,348,-78,426
guava,383,2017-01-14 21:00:00,1361,-590,1951
guava,384,2017-01-21 21:00:00,150,-107,257
guava,385,2017-01-28 21:00:00,319,-84,403
guava,386,2017-02-04 21:00:00,418,-569,987
guava,387,2017-02-11 21:00:00,560,-71,631
guava,388,2017-02-18 21:00:00,925,-645,1570
guava,389,2017-02-25 21:00:00,309,-168,477
guava,390,2017-03-04 21:00:00,340,-67,407
guava,391,2017-03-11 21:00:00,547,-141,688
guava,392,2017-03-18 21:00:00,1253,-470,1723
guava,393,2017-03-25 21:00:00,1750,-608,2358
guava,394,2017-04-01 21:00:00,434,-134,568
guava,395,2017-04-08 21:00:00,977,-356,1333
guava,396,2017-04-15 21:00:00,457085,-111,457196
guava,397,2017-04-22 21:00:00,4481,-1138,5619
guava,398,2017-04-29 21:00:00,5107,-370,5477
guava,399,2017-05-06 21:00:00,411,-349,760
guava,400,2017-05-13 21:00:00,949,-879,1828
guava,401,2017-05-20 21:00:00,1163,-1067,2230
guava,402,2017-05-27 21:00:00,2675,-1090,3765
guava,403,2017-06-03 21:00:00,1287,-607,1894
guava,404,2017-06-10 21:00:00,1715,-151,1866
guava,405,2017-06-17 21:00:00,291,-96,387
guava,406,2017-06-24 21:00:00,902,-64,966
guava,407,2017-07-01 21:00:00,803,-402,1205
guava,408,2017-07-08 21:00:00,2231,-579,2810
guava,409,2017-07-15 21:00:00,1200,-540,1740
guava,410,2017-07-22 21:00:00,1283,-1244,2527
guava,411,2017-07-29 21:00:00,286,-183,469
guava,412,2017-08-05 21:00:00,688,-458,1146
guava,413,2017-08-12 21:00:00,4571,-3951,8522
guava,414,2017-08-19 21:00:00,56,-5,61
guava,415,2017-08-26 21:00:00,1210,-1100,2310
guava,416,2017-09-02 21:00:00,11,-27,38
guava,417,2017-09-09 21:00:00,2825,-463,3288
guava,418,2017-09-16 21:00:00,2856,-202,3058
guava,419,2017-09-23 21:00:00,906,-878,1784
guava,420,2017-09-30 21:00:00,584,-135,719
guava,421,2017-10-07 21:00:00,1650,-276,1926
guava,422,2017-10-14 21:00:00,1736,-347,2083
guava,423,2017-10-21 21:00:00,294,-134,428
guava,424,2017-10-28 21:00:00,581,-255,836
guava,425,2017-11-04 21:00:00,860,-668,1528
guava,426,2017-11-11 21:00:00,1069,-845,1914
guava,427,2017-11-18 21:00:00,135,-66,201
guava,428,2017-11-25 21:00:00,853,-427,1280
guava,429,2017-12-02 21:00:00,86958,-81867,168825
guava,430,2017-12-09 21:00:00,4898,-110,5008
guava,431,2017-12-16 21:00:00,883,-512,1395
guava,432,2017-12-23 21:00:00,565,-247,812
guava,433,2017-12-30 21:00:00,382,-288,670
guava,434,2018-01-06 21:00:00,2281,-834,3115
guava,435,2018-01-13 21:00:00,1319,-364,1683
guava,436,2018-01-20 21:00:00,182,-1285,1467
guava,437,2018-01-27 21:00:00,753,-103,856
guava,438,2018-02-03 21:00:00,5584,-4031,9615
guava,439,2018-02-10 21:00:00,706,-311,1017
guava,440,2018-02-17 21:00:00,2,-50,52
guava,441,2018-02-24 21:00:00,2349,-838,3187
guava,442,2018-03-03 21:00:00,36,-16,52
guava,443,2018-03-10 21:00:00,63,-29,92
guava,444,2018-03-17 21:00:00,663,-585,1248
guava,445,2018-03-24 21:00:00,557,-21,578
guava,446,2018-03-31 21:00:00,20,-7,27
guava,447,2018-04-07 21:00:00,18,-18,36
guava,448,2018-04-14 21:00:00,156,-92,248
guava,449,2018-04-21 21:00:00,78,-287,365
guava,450,2018-04-28 21:00:00,12,-17,29
guava,451,2018-05-05 21:00:00,2059,-2038,4097
guava,452,2018-05-12 21:00:00,952,-1044,1996
guava,453,2018-05-19 21:00:00,626,-603,1229
guava,454,2018-05-26 21:00:00,189,-83,272
guava,455,2018-06-02 21:00:00,29,-29,58
guava,456,2018-06-09 21:00:00,343,-8,351
guava,457,2018-06-16 21:00:00,56,-100,156
guava,458,2018-06-23 21:00:00,269,-225,494
guava,459,2018-06-30 21:00:00,18,-4,22
guava,460,2018-07-07 21:00:00,118,-52,170
guava,461,2018-07-14 21:00:00,18,-596,614
guava,462,2018-07-21 21:00:00,58,-372,430
guava,463,2018-07-28 21:00:00,1582,-821,2403
guava,464,2018-08-04 21:00:00,700,-119,819
guava,465,2018-08-11 21:00:00,607,-159,766
guava,466,2018-08-18 21:00:00,310,-268,578
guava,467,2018-08-25 21:00:00,274,-12,286
guava,468,2018-09-01 21:00:00,134,-104,238
guava,469,2018-09-08 21:00:00,985,-85,1070
guava,470,2018-09-15 21:00:00,115,-48,163
guava,471,2018-09-22 21:00:00,39,-12,51
guava,472,2018-09-29 21:00:00,0,0,0
guava,473,2018-10-06 21:00:00,2,-2,4
guava,474,2018-10-13 21:00:00,203,-77,280
guava,475,2018-10-20 21:00:00,2172,-98,2270
guava,476,2018-10-27 21:00:00,41,-10,51
guava,477,2018-11-03 21:00:00,61,-30,91
guava,478,2018-11-10 21:00:00,16,-4,20
guava,479,2018-11-17 21:00:00,145,-9,154
guava,480,2018-11-24 21:00:00,577,-448,1025
guava,481,2018-12-01 21:00:00,9,-6,15
guava,482,2018-12-08 21:00:00,41,-1,42
guava,483,2018-12-15 21:00:00,26,-16,42
guava,484,2018-12-22 21:00:00,0,0,0
guava,485,2018-12-29 21:00:00,13,-2,15
guava,486,2019-01-05 21:00:00,45,0,45
guava,487,2019-01-12 21:00:00,60,-4,64
guava,488,2019-01-19 21:00:00,12,-38,50
guava,489,2019-01-26 21:00:00,677,-440,1117
guava,490,2019-02-02 21:00:00,517,-357,874
guava,491,2019-02-09 21:00:00,587,-971,1558
guava,492,2019-02-16 21:00:00,24,-12,36
guava,493,2019-02-23 21:00:00,12,-1171,1183
guava,494,2019-03-02 21:00:00,303,-189,492
guava,495,2019-03-09 21:00:00,563,-54,617
guava,496,2019-03-16 21:00:00,1032,-98,1130
guava,497,2019-03-23 21:00:00,663,-420,1083
guava,498,2019-03-30 21:00:00,6,-6,12
guava,499,2019-04-06 21:00:00,234,-48,282
guava,500,2019-04-13 21:00:00,133,-30,163
guava,501,2019-04-20 21:00:00,82,-88,170
guava,502,2019-04-27 21:00:00,507,-2318,2825
guava,503,2019-05-04 21:00:00,116,-17,133
guava,504,2019-05-11 21:00:00,373,-16,389
guava,505,2019-05-18 21:00:00,361,-40,401
guava,506,2019-05-25 21:00:00,272,-66,338
guava,507,2019-06-01 21:00:00,60,-68,128
guava,508,2019-06-08 21:00:00,274,-156,430
guava,509,2019-06-15 21:00:00,2,-3,5
guava,510,2019-06-22 21:00:00,151,-44,195
guava,511,2019-06-29 21:00:00,405,-359,764
guava,512,2019-07-06 21:00:00,16,-14,30
guava,513,2019-07-13 21:00:00,295,0,295
guava,514,2019-07-20 21:00:00,1,0,1
guava,515,2019-07-27 21:00:00,41,-19,60
guava,516,2019-08-03 21:00:00,220,-36,256
guava,517,2019-08-10 21:00:00,661,-123,784
guava,518,2019-08-17 21:00:00,51,-4,55
guava,519,2019-08-24 21:00:00,1476,-774,2250
guava,520,2019-08-31 21:00:00,106,-98,204
guava,521,2019-09-07 21:00:00,356,-310,666
guava,522,2019-09-14 21:00:00,159,-203,362
guava,523,2019-09-21 21:00:00,58,-3,61
guava,524,2019-09-28 21:00:00,788,-104,892
guava,525,2019-10-05 21:00:00,646,-144,790
guava,526,2019-10-12 21:00:00,645,-369,1014
guava,527,2019-10-19 21:00:00,1634,-1006,2640
guava,528,2019-10-26 21:00:00,514,-277,791
guava,529,2019-11-02 21:00:00,190,-72,262
guava,530,2019-11-09 21:00:00,908,-376,1284
guava,531,2019-11-16 21:00:00,10,-10,20
guava,532,2019-11-23 21:00:00,4638,-3307,7945
guava,533,2019-11-30 21:00:00,463,-284,747
guava,534,2019-12-07 21:00:00,12,-6,18
guava,535,2019-12-14 21:00:00,1104,-987,2091
guava,536,2019-12-21 21:00:00,100,-78,178
guava,537,2019-12-28 21:00:00,39,-21,60
guava,538,2020-01-04 21:00:00,1015,-222,1237
guava,539,2020-01-11 21:00:00,42,-23,65
guava,540,2020-01-18 21:00:00,26,-45,71
guava,541,2020-01-25 21:00:00,0,0,0
guava,542,2020-02-01 21:00:00,162,-10,172
guava,543,2020-02-08 21:00:00,902,-898,1800
guava,544,2020-02-15 21:00:00,52,-62,114
guava,545,2020-02-22 21:00:00,4141,-3514,7655
guava,546,2020-02-29 21:00:00,416,-422,838
guava,547,2020-03-07 21:00:00,3633,-3754,7387
guava,548,2020-03-14 21:00:00,351,-8,359
guava,549,2020-03-21 21:00:00,48,-4,52
guava,550,2020-03-28 21:00:00,676,-70,746
guava,551,2020-04-04 21:00:00,643,-710,1353
guava,552,2020-04-11 21:00:00,53,-35,88
guava,553,2020-04-18 21:00:00,80,-13,93
guava,554,2020-04-25 21:00:00,32,-4,36
guava,555,2020-05-02 21:00:00,291,-2,293
guava,556,2020-05-09 21:00:00,169,-14,183
guava,557,2020-05-16 21:00:00,0,0,0
guava,558,2020-05-23 21:00:00,2,0,2
guava,559,2020-05-30 21:00:00,1059,-36,1095
guava,560,2020-06-06 21:00:00,600,-182,782
guava,561,2020-06-13 21:00:00,1987,-743,2730
guava,562,2020-06-20 21:00:00,989,-328,1317
guava,563,2020-06-27 21:00:00,4,-6,10
guava,564,2020-07-04 21:00:00,300,-270,570
guava,565,2020-07-11 21:00:00,304,-550,854
guava,566,2020-07-18 21:00:00,351,-116,467
guava,567,2020-07-25 21:00:00,0,0,0
guava,568,2020-08-01 21:00:00,543,-308,851
guava,569,2020-08-08 21:00:00,211,-111,322
guava,570,2020-08-15 21:00:00,577,-87,664
guava,571,2020-08-22 21:00:00,92,-10,102
guava,572,2020-08-29 21:00:00,7,-7,14
guava,573,2020-09-05 21:00:00,8271,-6,8277
guava,574,2020-09-12 21:00:00,282,-75,357
guava,575,2020-09-19 21:00:00,168,-169,337
guava,576,2020-09-26 21:00:00,66,-39637,39703
guava,577,2020-10-03 21:00:00,467,-861,1328
guava,578,2020-10-10 21:00:00,563,-295,858
guava,579,2020-10-17 21:00:00,54,-22,76
guava,580,2020-10-24 21:00:00,583,-485,1068
guava,581,2020-10-31 21:00:00,988,-918,1906
guava,582,2020-11-07 21:00:00,1386,-578,1964
guava,583,2020-11-14 21:00:00,119,-97,216
guava,584,2020-11-21 21:00:00,34,-18,52
guava,585,2020-11-28 21:00:00,105,-49,154
guava,586,2020-12-05 21:00:00,264,-8,272
guava,587,2020-12-12 21:00:00,1311,-942,2253
guava,588,2020-12-19 21:00:00,769,-157,926
guava,589,2020-12-26 21:00:00,5,-6,11
guava,590,2021-01-02 21:00:00,4,-4,8
guava,591,2021-01-09 21:00:00,0,0,0
guava,592,2021-01-16 21:00:00,2,-6,8
guava,593,2021-01-23 21:00:00,2,-4,6
guava,594,2021-01-30 21:00:00,42,-2,44
guava,595,2021-02-06 21:00:00,89,-10,99
guava,596,2021-02-13 21:00:00,12,-10,22
guava,597,2021-02-20 21:00:00,239,-442,681
guava,598,2021-02-27 21:00:00,226,-34,260
guava,599,2021-03-06 21:00:00,66,-98,164
guava,600,2021-03-13 21:00:00,149,-94,243
guava,601,2021-03-20 21:00:00,91,-231,322
guava,602,2021-03-27 21:00:00,267,-102,369
guava,603,2021-04-03 21:00:00,360,-163,523
guava,604,2021-04-10 21:00:00,1861,-459,2320
guava,605,2021-04-17 21:00:00,1540,-403,1943
guava,606,2021-04-24 21:00:00,2234,-758,2992
guava,607,2021-05-01 21:00:00,1757,-601,2358
guava,608,2021-05-08 21:00:00,910,-662,1572
guava,609,2021-05-15 21:00:00,1606,-1224,2830
guava,610,2021-05-22 21:00:00,1485,-1157,2642
guava,611,2021-05-29 21:00:00,1459,-860,2319
guava,612,2021-06-05 21:00:00,20,-14,34
guava,613,2021-06-12 21:00:00,2788,-1579,4367
guava,614,2021-06-19 21:00:00,1208,-681,1889
guava,615,2021-06-26 21:00:00,4101,-2184,6285
guava,616,2021-07-03 21:00:00,716,-424,1140
guava,617,2021-07-10 21:00:00,920,-576,1496
guava,618,2021-07-17 21:00:00,946,-449,1395
guava,619,2021-07-24 21:00:00,46,-6,52
guava,620,2021-07-31 21:00:00,1545,-869,2414
guava,621,2021-08-07 21:00:00,158,-20,178
guava,622,2021-08-14 21:00:00,319,-157,476
guava,623,2021-08-21 21:00:00,76,-2,78
rails,580,2016-01-02 21:00:00,1777,-660,2437
rails,581,2016-01-09 21:00:00,1415,-1091,2506
rails,582,2016-01-16 21:00:00,2044,-818,2862
rails,583,2016-01-23 21:00:00,3602,-2440,6042
rails,584,2016-01-30 21:00:00,2154,-1589,3743
rails,585,2016-02-06 21:00:00,1950,-769,2719
rails,586,2016-02-13 21:00:00,1770,-1075,2845
rails,587,2016-02-20 21:00:00,2973,-1748,4721
rails,588,2016-02-27 21:00:00,1857,-1271,3128
rails,589,2016-03-05 21:00:00,820,-472,1292
rails,590,2016-03-12 21:00:00,1078,-368,1446
rails,591,2016-03-19 21:00:00,557,-168,725
rails,592,2016-03-26 21:00:00,655,-365,1020
rails,593,2016-04-02 21:00:00,518,-171,689
rails,594,2016-04-09 21:00:00,931,-356,1287
rails,595,2016-04-16 21:00:00,1292,-430,1722
rails,596,2016-04-23 21:00:00,767,-504,1271
rails,597,2016-04-30 21:00:00,1042,-541,1583
rails,598,2016-05-07 21:00:00,6242,-5970,12212
rails,599,2016-05-14 21:00:00,886,-591,1477
rails,600,2016-05-21 21:00:00,1774,-881,2655
rails,601,2016-05-28 21:00:00,930,-861,1791
rails,602,2016-06-04 21:00:00,1129,-331,1460
rails,603,2016-06-11 21:00:00,871,-254,1125
rails,604,2016-06-18 21:00:00,541,-691,1232
rails,605,2016-06-25 21:00:00,1641,-736,2377
rails,606,2016-07-02 21:00:00,687,-5543,6230
rails,607,2016-07-09 21:00:00,947,-369,1316
rails,608,2016-07-16 21:00:00,881,-463,1344
rails,609,2016-07-23 21:00:00,676,-613,1289
rails,610,2016-07-30 21:00:00,42810,-42377,85187
rails,611,2016-08-06 21:00:00,1111,-667,1778
rails,612,2016-08-13 21:00:00,2885,-2707,5592
rails,613,2016-08-20 21:00:00,954,-833,1787
rails,614,2016-08-27 21:00:00,860,-520,1380
rails,615,2016-09-03 21:00:00,488,-304,792
rails,616,2016-09-10 21:00:00,2716,-3136,5852
rails,617,2016-09-17 21:00:00,482,-199,681
rails,618,2016-09-24 21:00:00,769,-646,1415
rails,619,2016-10-01 21:00:00,885,-459,1344
rails,620,2016-10-08 21:00:00,766,-1320,2086
rails,621,2016-10-15 21:00:00,446,-110,556
rails,622,2016-10-22 21:00:00,2687,-2477,5164
rails,623,2016-10-29 21:00:00,250,-133,383
rails,624,2016-11-05 21:00:00,1517,-1002,2519
rails,625,2016-11-12 21:00:00,1096,-1899,2995
rails,626,2016-11-19 21:00:00,9896,-1051,10947
rails,627,2016-11-26 21:00:00,588,-343,931
rails,628,2016-12-03 21:00:00,614,-281,895
rails,629,2016-12-10 21:00:00,737,-419,1156
rails,630,2016-12-17 21:00:00,1710,-1311,3021
rails,631,2016-12-24 21:00:00,2425,-1926,4351
rails,632,2016-12-31 21:00:00,943,-986,1929
rails,633,2017-01-07 21:00:00,1299,-969,2268
rails,634,2017-01-14 21:00:00,1274,-543,1817
rails,635,2017-01-21 21:00:00,709,-677,1386
rails,636,2017-01-28 21:00:00,792,-491,1283
rails,637,2017-02-04 21:00:00,920,-638,1558
rails,638,2017-02-11 21:00:00,1161,-861,2022
rails,639,2017-02-18 21:00:00,4606,-2776,7382
rails,640,2017-02-25 21:00:00,1946,-790,2736
rails,641,2017-03-04 21:00:00,998,-465,1463
rails,642,2017-03-11 21:00:00,1137,-447,1584
rails,643,2017-03-18 21:00:00,775,-2830,3605
rails,644,2017-03-25 21:00:00,1889,-1443,3332
rails,645,2017-04-01 21:00:00,442,-158,600
rails,646,2017-04-08 21:00:00,889,-522,1411
rails,647,2017-04-15 21:00:00,667,-374,1041
rails,648,2017-04-22 21:00:00,1341,-593,1934
rails,649,2017-04-29 21:00:00,427,-353,780
rails,650,2017-05-06 21:00:00,507,-187,694
rails,651,2017-05-13 21:00:00,1905,-698,2603
rails,652,2017-05-20 21:00:00,1182,-1003,2185
rails,653,2017-05-27 21:00:00,805,-571,1376
rails,654,2017-06-03 21:00:00,2037,-1687,3724
rails,655,2017-06-10 21:00:00,759,-455,1214
rails,656,2017-06-17 21:00:00,3129,-475,3604
rails,657,2017-06-24 21:00:00,2467,-1487,3954
rails,658,2017-07-01 21:00:00,5364,-5621,10985
rails,659,2017-07-08 21:00:00,4191,-848,5039
rails,660,2017-07-15 21:00:00,13709,-2904,16613
rails,661,2017-07-22 21:00:00,7992,-1879,9871
rails,662,2017-07-29 21:00:00,2177,-1816,3993
rails,663,2017-08-05 21:00:00,1752,-932,2684
rails,664,2017-08-12 21:00:00,1852,-862,2714
rails,665,2017-08-19 21:00:00,842,-823,1665
rails,666,2017-08-26 21:00:00,504,-297,801
rails,667,2017-09-02 21:00:00,555,-471,1026
rails,668,2017-09-09 21:00:00,1961,-1107,3068
rails,669,2017-09-16 21:00:00,1537,-580,2117
rails,670,2017-09-23 21:00:00,2357,-1379,3736
rails,671,2017-09-30 21:00:00,358,-234,592
rails,672,2017-10-07 21:00:00,1036,-389,1425
rails,673,2017-10-14 21:00:00,3502,-2789,6291
rails,674,2017-10-21 21:00:00,1342,-948,2290
rails,675,2017-10-28 21:00:00,419,-255,674
rails,676,2017-11-04 21:00:00,989,-464,1453
rails,677,2017-11-11 21:00:00,4611,-2801,7412
rails,678,2017-11-18 21:00:00,688,-195,883
rails,679,2017-11-25 21:00:00,1778,-611,2389
rails,680,2017-12-02 21:00:00,1391,-412,1803
rails,681,2017-12-09 21:00:00,2967,-1621,4588
rails,682,2017-12-16 21:00:00,1116,-198,1314
rails,683,2017-12-23 21:00:00,590,-383,973
rails,684,2017-12-30 21:00:00,458,-222,680
rails,685,2018-01-06 21:00:00,1228,-1019,2247
rails,686,2018-01-13 21:00:00,3599,-619,4218
rails,687,2018-01-20 21:00:00,3085,-2820,5905
rails,688,2018-01-27 21:00:00,508,-2204,2712
rails,689,2018-02-03 21:00:00,3254,-649,3903
rails,690,2018-02-10 21:00:00,8081,-1386,9467
rails,691,2018-02-17 21:00:00,4303,-3616,7919
rails,692,2018-02-24 21:00:00,1591,-1308,2899
rails,693,2018-03-03 21:00:00,1821,-481,2302
rails,694,2018-03-10 21:00:00,1160,-689,1849
rails,695,2018-03-17 21:00:00,896,-489,1385
rails,696,2018-03-24 21:00:00,516,-405,921
rails,697,2018-03-31 21:00:00,1359,-620,1979
rails,698,2018-04-07 21:00:00,1497,-1148,2645
rails,699,2018-04-14 21:00:00,1295,-783,2078
rails,700,2018-04-21 21:00:00,2221,-2029,4250
rails,701,2018-04-28 21:00:00,352,-170,522
rails,702,2018-05-05 21:00:00,444,-240,684
rails,703,2018-05-12 21:00:00,1541,-1081,2622
rails,704,2018-05-19 21:00:00,422,-98,520
rails,705,2018-05-26 21:00:00,1013,-448,1461
rails,706,2018-06-02 21:00:00,468,-301,769
rails,707,2018-06-09 21:00:00,880,-331,1211
rails,708,2018-06-16 21:00:00,487,-280,767
rails,709,2018-06-23 21:00:00,1012,-522,1534
rails,710,2018-06-30 21:00:00,1341,-1094,2435
rails,711,2018-07-07 21:00:00,1405,-695,2100
rails,712,2018-07-14 21:00:00,996,-465,1461
rails,713,2018-07-21 21:00:00,1048,-347,1395
rails,714,2018-07-28 21:00:00,193,-122,315
rails,715,2018-08-04 21:00:00,749,-265,1014
rails,716,2018-08-11 21:00:00,2759,-470,3229
rails,717,2018-08-18 21:00:00,1181,-422,1603
rails,718,2018-08-25 21:00:00,1002,-386,1388
rails,719,2018-09-01 21:00:00,1163,-974,2137
rails,720,2018-09-08 21:00:00,928,-498,1426
rails,721,2018-09-15 21:00:00,10325,-1284,11609
rails,722,2018-09-22 21:00:00,4066,-1924,5990
rails,723,2018-09-29 21:00:00,3688,-2060,5748
rails,724,2018-10-06 21:00:00,1204,-554,1758
rails,725,2018-10-13 21:00:00,1031,-675,1706
rails,726,2018-10-20 21:00:00,357,-200,557
rails,727,2018-10-27 21:00:00,644,-400,1044
rails,728,2018-11-03 21:00:00,1082,-499,1581
rails,729,2018-11-10 21:00:00,887,-156,1043
rails,730,2018-11-17 21:00:00,1557,-103,1660
rails,731,2018-11-24 21:00:00,9793,-11389,21182
rails,732,2018-12-01 21:00:00,595,-142,737
rails,733,2018-12-08 21:00:00,1831,-582,2413
rails,734,2018-12-15 21:00:00,1811,-2052,3863
rails,735,2018-12-22 21:00:00,5813,-1361,7174
rails,736,2018-12-29 21:00:00,2017,-4337,6354
rails,737,2019-01-05 21:00:00,1644,-681,2325
rails,738,2019-01-12 21:00:00,2351,-2466,4817
rails,739,2019-01-19 21:00:00,1213,-808,2021
rails,740,2019-01-26 21:00:00,991,-491,1482
rails,741,2019-02-02 21:00:00,1301,-491,1792
rails,742,2019-02-09 21:00:00,2004,-769,2773
rails,743,2019-02-16 21:00:00,1155,-366,1521
rails,744,2019-02-23 21:00:00,910,-560,1470
rails,745,2019-03-02 21:00:00,10004,-5564,15568
rails,746,2019-03-09 21:00:00,1768,-552,2320
rails,747,2019-03-16 21:00:00,1755,-790,2545
rails,748,2019-03-23 21:00:00,887,-320,1207
rails,749,2019-03-30 21:00:00,1591,-954,2545
rails,750,2019-04-06 21:00:00,1690,-785,2475
rails,751,2019-04-13 21:00:00,1493,-730,2223
rails,752,2019-04-20 21:00:00,960,-3714,4674
rails,753,2019-04-27 21:00:00,1006,-509,1515
rails,754,2019-05-04 21:00:00,1169,-748,1917
rails,755,2019-05-11 21:00:00,1565,-1438,3003
rails,756,2019-05-18 21:00:00,516,-397,913
rails,757,2019-05-25 21:00:00,829,-274,1103
rails,758,2019-06-01 21:00:00,1003,-268,1271
rails,759,2019-06-08 21:00:00,746,-1378,2124
rails,760,2019-06-15 21:00:00,467,-204,671
rails,761,2019-06-22 21:00:00,353,-79,432
rails,762,2019-06-29 21:00:00,199,-34,233
rails,763,2019-07-06 21:00:00,2873,-1901,4774
rails,764,2019-07-13 21:00:00,664,-140,804
rails,765,2019-07-20 21:00:00,1367,-394,1761
rails,766,2019-07-27 21:00:00,1475,-871,2346
rails,767,2019-08-03 21:00:00,763,-379,1142
rails,768,2019-08-10 21:00:00,340,-125,465
rails,769,2019-08-17 21:00:00,491,-224,715
rails,770,2019-08-24 21:00:00,539,-340,879
rails,771,2019-08-31 21:00:00,582,-354,936
rails,772,2019-09-07 21:00:00,1995,-1480,3475
rails,773,2019-09-14 21:00:00,930,-580,1510
rails,774,2019-09-21 21:00:00,1052,-398,1450
rails,775,2019-09-28 21:00:00,1364,-946,2310
rails,776,2019-10-05 21:00:00,888,-579,1467
rails,777,2019-10-12 21:00:00,719,-514,1233
rails,778,2019-10-19 21:00:00,310,-149,459
rails,779,2019-10-26 21:00:00,879,-193,1072
rails,780,2019-11-02 21:00:00,1394,-581,1975
rails,781,2019-11-09 21:00:00,621,-473,1094
rails,782,2019-11-16 21:00:00,244,-193,437
rails,783,2019-11-23 21:00:00,668,-247,915
rails,784,2019-11-30 21:00:00,1269,-562,1831
rails,785,2019-12-07 21:00:00,1013,-813,1826
rails,786,2019-12-14 21:00:00,1461,-775,2236
rails,787,2019-12-21 21:00:00,496,-277,773
rails,788,2019-12-28 21:00:00,590,-553,1143
rails,789,2020-01-04 21:00:00,912,-280,1192
rails,790,2020-01-11 21:00:00,669,-139,808
rails,791,2020-01-18 21:00:00,1469,-376,1845
rails,792,2020-01-25 21:00:00,511,-147,658
rails,793,2020-02-01 21:00:00,322,-220,542
rails,794,2020-02-08 21:00:00,593,-105,698
rails,795,2020-02-15 21:00:00,1097,-482,1579
rails,796,2020-02-22 21:00:00,1653,-1190,2843
rails,797,2020-02-29 21:00:00,941,-555,1496
rails,798,2020-03-07 21:00:00,613,-285,898
rails,799,2020-03-14 21:00:00,948,-244,1192
rails,800,2020-03-21 21:00:00,388,-187,575
rails,801,2020-03-28 21:00:00,793,-377,1170
rails,802,2020-04-04 21:00:00,845,-665,1510
rails,803,2020-04-11 21:00:00,251,-1482,1733
rails,804,2020-04-18 21:00:00,533,-979,1512
rails,805,2020-04-25 21:00:00,1177,-779,1956
rails,806,2020-05-02 21:00:00,2200,-2652,4852
rails,807,2020-05-09 21:00:00,2492,-960,3452
rails,808,2020-05-16 21:00:00,1695,-634,2329
rails,809,2020-05-23 21:00:00,1897,-1205,3102
rails,810,2020-05-30 21:00:00,1019,-427,1446
rails,811,2020-06-06 21:00:00,1815,-1464,3279
rails,812,2020-06-13 21:00:00,607,-333,940
rails,813,2020-06-20 21:00:00,875,-911,1786
rails,814,2020-06-27 21:00:00,698,-466,1164
rails,815,2020-07-04 21:00:00,411,-139,550
rails,816,2020-07-11 21:00:00,566,-187,753
rails,817,2020-07-18 21:00:00,480,-515,995
rails,818,2020-07-25 21:00:00,769,-369,1138
rails,819,2020-08-01 21:00:00,1055,-347,1402
rails,820,2020-08-08 21:00:00,1272,-707,1979
rails,821,2020-08-15 21:00:00,114,-71,185
rails,822,2020-08-22 21:00:00,871,-513,1384
rails,823,2020-08-29 21:00:00,395,-166,561
rails,824,2020-09-05 21:00:00,3717,-892,4609
rails,825,2020-09-12 21:00:00,552,-218,770
rails,826,2020-09-19 21:00:00,615,-301,916
rails,827,2020-09-26 21:00:00,660,-317,977
rails,828,2020-10-03 21:00:00,582,-369,951
rails,829,2020-10-10 21:00:00,278,-50,328
rails,830,2020-10-17 21:00:00,853,-223,1076
rails,831,2020-10-24 21:00:00,2543,-3339,5882
rails,832,2020-10-31 21:00:00,1940,-676,2616
rails,833,2020-11-07 21:00:00,1843,-1306,3149
rails,834,2020-11-14 21:00:00,452,-178,630
rails,835,2020-11-21 21:00:00,997,-288,1285
rails,836,2020-11-28 21:00:00,630,-3901,4531
rails,837,2020-12-05 21:00:00,727,-122,849
rails,838,2020-12-12 21:00:00,1335,-288,1623
rails,839,2020-12-19 21:00:00,865,-742,1607
rails,840,2020-12-26 21:00:00,674,-285,959
rails,841,2021-01-02 21:00:00,700,-409,1109
rails,842,2021-01-09 21:00:00,723,-311,1034
rails,843,2021-01-16 21:00:00,2063,-978,3041
rails,844,2021-01-23 21:00:00,1007,-160,1167
rails,845,2021-01-30 21:00:00,1960,-1687,3647
rails,846,2021-02-06 21:00:00,1477,-490,1967
rails,847,2021-02-13 21:00:00,1290,-587,1877
rails,848,2021-02-20 21:00:00,4722,-362,5084
rails,849,2021-02-27 21:00:00,1465,-650,2115
rails,850,2021-03-06 21:00:00,2523,-1294,3817
rails,851,2021-03-13 21:00:00,553,-516,1069
rails,852,2021-03-20 21:00:00,1129,-517,1646
rails,853,2021-03-27 21:00:00,818,-1313,2131
rails,854,2021-04-03 21:00:00,718,-541,1259
rails,855,2021-04-10 21:00:00,1625,-1138,2763
rails,856,2021-04-17 21:00:00,1900,-788,2688
rails,857,2021-04-24 21:00:00,1016,-399,1415
rails,858,2021-05-01 21:00:00,1169,-396,1565
rails,859,2021-05-08 21:00:00,1222,-502,1724
rails,860,2021-05-15 21:00:00,576,-190,766
rails,861,2021-05-22 21:00:00,471,-130,601
rails,862,2021-05-29 21:00:00,1046,-485,1531
rails,863,2021-06-05 21:00:00,1461,-759,2220
rails,864,2021-06-12 21:00:00,2067,-1163,3230
rails,865,2021-06-19 21:00:00,1037,-523,1560
rails,866,2021-06-26 21:00:00,1112,-364,1476
rails,867,2021-07-03 21:00:00,546,-130,676
rails,868,2021-07-10 21:00:00,1452,-717,2169
rails,869,2021-07-17 21:00:00,443,-309,752
rails,870,2021-07-24 21:00:00,4804,-2550,7354
rails,871,2021-07-31 21:00:00,2334,-533,2867
rails,872,2021-08-07 21:00:00,5619,-2076,7695
rails,873,2021-08-14 21:00:00,822,-1132,1954
rails,874,2021-08-21 21:00:00,1290,-2624,3914
jquery,511,2016-01-02 21:00:00,76,-18,94
jquery,512,2016-01-09 21:00:00,744,-275,1019
jquery,513,2016-01-16 21:00:00,282,-78,360
jquery,514,2016-01-23 21:00:00,10251,-8251,18502
jquery,515,2016-01-30 21:00:00,7,-2,9
jquery,516,2016-02-06 21:00:00,108,-134,242
jquery,517,2016-02-13 21:00:00,9,-8,17
jquery,518,2016-02-20 21:00:00,151,-258,409
jquery,519,2016-02-27 21:00:00,62,-21,83
jquery,520,2016-03-05 21:00:00,151,-58,209
jquery,521,2016-03-12 21:00:00,133,-36,169
jquery,522,2016-03-19 21:00:00,104,-121,225
jquery,523,2016-03-26 21:00:00,59,-60,119
jquery,524,2016-04-02 21:00:00,177,-118,295
jquery,525,2016-04-09 21:00:00,563,-396,959
jquery,526,2016-04-16 21:00:00,81,-41,122
jquery,527,2016-04-23 21:00:00,342,-33,375
jquery,528,2016-04-30 21:00:00,87,-55,142
jquery,529,2016-05-07 21:00:00,656,-631,1287
jquery,530,2016-05-14 21:00:00,101,-32,133
jquery,531,2016-05-21 21:00:00,0,0,0
jquery,532,2016-05-28 21:00:00,47,-9,56
jquery,533,2016-06-04 21:00:00,118,-80,198
jquery,534,2016-06-11 21:00:00,7,-3,10
jquery,535,2016-06-18 21:00:00,106,-12,118
jquery,536,2016-06-25 21:00:00,74,-2,76
jquery,537,2016-07-02 21:00:00,20,-8,28
jquery,538,2016-07-09 21:00:00,173,-89,262
jquery,539,2016-07-16 21:00:00,0,0,0
jquery,540,2016-07-23 21:00:00,181,-160,341
jquery,541,2016-07-30 21:00:00,53,-26,79
jquery,542,2016-08-06 21:00:00,100,-45,145
jquery,543,2016-08-13 21:00:00,47,-50,97
jquery,544,2016-08-20 21:00:00,4,-10,14
jquery,545,2016-08-27 21:00:00,7,-18,25
jquery,546,2016-09-03 21:00:00,0,0,0
jquery,547,2016-09-10 21:00:00,139,-58,197
jquery,548,2016-09-17 21:00:00,14,-28,42
jquery,549,2016-09-24 21:00:00,96,-103,199
jquery,550,2016-10-01 21:00:00,0,0,0
jquery,551,2016-10-08 21:00:00,0,0,0
jquery,552,2016-10-15 21:00:00,1,-1,2
jquery,553,2016-10-22 21:00:00,1,0,1
jquery,554,2016-10-29 21:00:00,90,-39,129
jquery,555,2016-11-05 21:00:00,0,-1,1
jquery,556,2016-11-12 21:00:00,0,0,0
jquery,557,2016-11-19 21:00:00,0,0,0
jquery,558,2016-11-26 21:00:00,8,-6,14
jquery,559,2016-12-03 21:00:00,5,-1,6
jquery,560,2016-12-10 21:00:00,48,-23,71
jquery,561,2016-12-17 21:00:00,29,-20,49
jquery,562,2016-12-24 21:00:00,11,-29,40
jquery,563,2016-12-31 21:00:00,1,-1,2
jquery,564,2017-01-07 21:00:00,420,-120,540
jquery,565,2017-01-14 21:00:00,92,-56,148
jquery,566,2017-01-21 21:00:00,0,0,0
jquery,567,2017-01-28 21:00:00,64,-1,65
jquery,568,2017-02-04 21:00:00,1,-1,2
jquery,569,2017-02-11 21:00:00,0,0,0
jquery,570,2017-02-18 21:00:00,0,0,0
jquery,571,2017-02-25 21:00:00,0,0,0
jquery,572,2017-03-04 21:00:00,182,-136,318
jquery,573,2017-03-11 21:00:00,64,-16,80
jquery,574,2017-03-18 21:00:00,64,-50,114
jquery,575,2017-03-25 21:00:00,2,-2,4
jquery,576,2017-04-01 21:00:00,0,0,0
jquery,577,2017-04-08 21:00:00,0,0,0
jquery,578,2017-04-15 21:00:00,0,0,0
jquery,579,2017-04-22 21:00:00,579,-155,734
jquery,580,2017-04-29 21:00:00,1,-3,4
jquery,581,2017-05-06 21:00:00,0,0,0
jquery,582,2017-05-13 21:00:00,42,-49,91
jquery,583,2017-05-20 21:00:00,0,0,0
jquery,584,2017-05-27 21:00:00,1,-1,2
jquery,585,2017-06-03 21:00:00,0,0,0
jquery,586,2017-06-10 21:00:00,89,-9,98
jquery,587,2017-06-17 21:00:00,204,-87,291
jquery,588,2017-06-24 21:00:00,3854,-17,3871
jquery,589,2017-07-01 21:00:00,3967,-1703,5670
jquery,590,2017-07-08 21:00:00,46,-18,64
jquery,591,2017-07-15 21:00:00,331,-302,633
jquery,592,2017-07-22 21:00:00,0,0,0
jquery,593,2017-07-29 21:00:00,3445,-2712,6157
jquery,594,2017-08-05 21:00:00,33,-6,39
jquery,595,2017-08-12 21:00:00,2,-1,3
jquery,596,2017-08-19 21:00:00,0,0,0
jquery,597,2017-08-26 21:00:00,37,-18,55
jquery,598,2017-09-02 21:00:00,9,-9,18
jquery,599,2017-09-09 21:00:00,60,-6,66
jquery,600,2017-09-16 21:00:00,47,-90,137
jquery,601,2017-09-23 21:00:00,342,-6391,6733
jquery,602,2017-09-30 21:00:00,0,0,0
jquery,603,2017-10-07 21:00:00,0,0,0
jquery,604,2017-10-14 21:00:00,21,-3,24
jquery,605,2017-10-21 21:00:00,0,0,0
jquery,606,2017-10-28 21:00:00,0,0,0
jquery,607,2017-11-04 21:00:00,1,0,1
jquery,608,2017-11-11 21:00:00,0,0,0
jquery,609,2017-11-18 21:00:00,86,-63,149
jquery,610,2017-11-25 21:00:00,3,0,3
jquery,611,2017-12-02 21:00:00,178,-38,216
jquery,612,2017-12-09 21:00:00,466,-436,902
jquery,613,2017-12-16 21:00:00,0,0,0
jquery,614,2017-12-23 21:00:00,79,-88,167
jquery,615,2017-12-30 21:00:00,128,-29,157
jquery,616,2018-01-06 21:00:00,24,-31,55
jquery,617,2018-01-13 21:00:00,147,-117,264
jquery,618,2018-01-20 21:00:00,0,0,0
jquery,619,2018-01-27 21:00:00,0,0,0
jquery,620,2018-02-03 21:00:00,0,0,0
jquery,621,2018-02-10 21:00:00,23,-19,42
jquery,622,2018-02-17 21:00:00,48,-39,87
jquery,623,2018-02-24 21:00:00,2,-2,4
jquery,624,2018-03-03 21:00:00,35,-28,63
jquery,625,2018-03-10 21:00:00,7,-2,9
jquery,626,2018-03-17 21:00:00,12,-7,19
jquery,627,2018-03-24 21:00:00,0,0,0
jquery,628,2018-03-31 21:00:00,0,0,0
jquery,629,2018-04-07 21:00:00,0,0,0
jquery,630,2018-04-14 21:00:00,1,-16,17
jquery,631,2018-04-21 21:00:00,387,-244,631
jquery,632,2018-04-28 21:00:00,15,-1,16
jquery,633,2018-05-05 21:00:00,34,-12,46
jquery,634,2018-05-12 21:00:00,98,-51,149
jquery,635,2018-05-19 21:00:00,0,0,0
jquery,636,2018-05-26 21:00:00,0,0,0
jquery,637,2018-06-02 21:00:00,18,-1,19
jquery,638,2018-06-09 21:00:00,0,0,0
jquery,639,2018-06-16 21:00:00,89,-22,111
jquery,640,2018-06-23 21:00:00,0,0,0
jquery,641,2018-06-30 21:00:00,0,0,0
jquery,642,2018-07-07 21:00:00,41,-3,44
jquery,643,2018-07-14 21:00:00,0,0,0
jquery,644,2018-07-21 21:00:00,2,0,2
jquery,645,2018-07-28 21:00:00,9,-3,12
jquery,646,2018-08-04 21:00:00,0,0,0
jquery,647,2018-08-11 21:00:00,0,0,0
jquery,648,2018-08-18 21:00:00,3,-3,6
jquery,649,2018-08-25 21:00:00,7,0,7
jquery,650,2018-09-01 21:00:00,79,-43,122
jquery,651,2018-09-08 21:00:00,0,0,0
jquery,652,2018-09-15 21:00:00,0,0,0
jquery,653,2018-09-22 21:00:00,0,0,0
jquery,654,2018-09-29 21:00:00,50,0,50
jquery,655,2018-10-06 21:00:00,9,-5,14
jquery,656,2018-10-13 21:00:00,0,0,0
jquery,657,2018-10-20 21:00:00,0,0,0
jquery,658,2018-10-27 21:00:00,1,0,1
jquery,659,2018-11-03 21:00:00,138,-15,153
jquery,660,2018-11-10 21:00:00,88,-50,138
jquery,661,2018-11-17 21:00:00,0,0,0
jquery,662,2018-11-24 21:00:00,17,-6,23
jquery,663,2018-12-01 21:00:00,5,-1,6
jquery,664,2018-12-08 21:00:00,51,-13,64
jquery,665,2018-12-15 21:00:00,0,0,0
jquery,666,2018-12-22 21:00:00,0,0,0
jquery,667,2018-12-29 21:00:00,0,0,0
jquery,668,2019-01-05 21:00:00,0,0,0
jquery,669,2019-01-12 21:00:00,73,-3,76
jquery,670,2019-01-19 21:00:00,98,-19,117
jquery,671,2019-01-26 21:00:00,1,-1,2
jquery,672,2019-02-02 21:00:00,0,0,0
jquery,673,2019-02-09 21:00:00,0,0,0
jquery,674,2019-02-16 21:00:00,11132,-5593,16725
jquery,675,2019-02-23 21:00:00,0,0,0
jquery,676,2019-03-02 21:00:00,6931,-4652,11583
jquery,677,2019-03-09 21:00:00,105,-14,119
jquery,678,2019-03-16 21:00:00,66,-14,80
jquery,679,2019-03-23 21:00:00,119,-97,216
jquery,680,2019-03-30 21:00:00,28479,-8435,36914
jquery,681,2019-04-06 21:00:00,65,-47,112
jquery,682,2019-04-13 21:00:00,13,-5,18
jquery,683,2019-04-20 21:00:00,146,-2,148
jquery,684,2019-04-27 21:00:00,759,-2109,2868
jquery,685,2019-05-04 21:00:00,23,-3,26
jquery,686,2019-05-11 21:00:00,321,-503,824
jquery,687,2019-05-18 21:00:00,0,0,0
jquery,688,2019-05-25 21:00:00,0,0,0
jquery,689,2019-06-01 21:00:00,0,0,0
jquery,690,2019-06-08 21:00:00,0,0,0
jquery,691,2019-06-15 21:00:00,0,0,0
jquery,692,2019-06-22 21:00:00,1884,-160,2044
jquery,693,2019-06-29 21:00:00,0,0,0
jquery,694,2019-07-06 21:00:00,0,0,0
jquery,695,2019-07-13 21:00:00,0,0,0
jquery,696,2019-07-20 21:00:00,0,0,0
jquery,697,2019-07-27 21:00:00,2198,-2989,5187
jquery,698,2019-08-03 21:00:00,1,-2,3
jquery,699,2019-08-10 21:00:00,370,-2,372
jquery,700,2019-08-17 21:00:00,187,-67,254
jquery,701,2019-08-24 21:00:00,140,-41642,41782
jquery,702,2019-08-31 21:00:00,0,0,0
jquery,703,2019-09-07 21:00:00,0,0,0
jquery,704,2019-09-14 21:00:00,0,0,0
jquery,705,2019-09-21 21:00:00,67,-26,93
jquery,706,2019-09-28 21:00:00,9,-5,14
jquery,707,2019-10-05 21:00:00,43,-34,77
jquery,708,2019-10-12 21:00:00,88,-10,98
jquery,709,2019-10-19 21:00:00,177,-153,330
jquery,710,2019-10-26 21:00:00,21,-9,30
jquery,711,2019-11-02 21:00:00,0,0,0
jquery,712,2019-11-09 21:00:00,0,0,0
jquery,713,2019-11-16 21:00:00,841,-1334,2175
jquery,714,2019-11-23 21:00:00,8,0,8
jquery,715,2019-11-30 21:00:00,52,-19,71
jquery,716,2019-12-07 21:00:00,103,-18,121
jquery,717,2019-12-14 21:00:00,191,-151,342
jquery,718,2019-12-21 21:00:00,0,0,0
jquery,719,2019-12-28 21:00:00,0,0,0
jquery,720,2020-01-04 21:00:00,269,-128,397
jquery,721,2020-01-11 21:00:00,88,-154,242
jquery,722,2020-01-18 21:00:00,94,-101,195
jquery,723,2020-01-25 21:00:00,2,-2,4
jquery,724,2020-02-01 21:00:00,0,0,0
jquery,725,2020-02-08 21:00:00,74,-16,90
jquery,726,2020-02-15 21:00:00,0,0,0
jquery,727,2020-02-22 21:00:00,3,0,3
jquery,728,2020-02-29 21:00:00,221,-88,309
jquery,729,2020-03-07 21:00:00,2,-2,4
jquery,730,2020-03-14 21:00:00,255,-262,517
jquery,731,2020-03-21 21:00:00,0,0,0
jquery,732,2020-03-28 21:00:00,0,0,0
jquery,733,2020-04-04 21:00:00,55,0,55
jquery,734,2020-04-11 21:00:00,4,-4,8
jquery,735,2020-04-18 21:00:00,21,-8,29
jquery,736,2020-04-25 21:00:00,163,-43,206
jquery,737,2020-05-02 21:00:00,70,-64,134
jquery,738,2020-05-09 21:00:00,12,0,12
jquery,739,2020-05-16 21:00:00,21,-83,104
jquery,740,2020-05-23 21:00:00,0,0,0
jquery,741,2020-05-30 21:00:00,5,-9,14
jquery,742,2020-06-06 21:00:00,24,-14,38
jquery,743,2020-06-13 21:00:00,0,0,0
jquery,744,2020-06-20 21:00:00,51,0,51
jquery,745,2020-06-27 21:00:00,0,0,0
jquery,746,2020-07-04 21:00:00,0,0,0
jquery,747,2020-07-11 21:00:00,24,-24,48
jquery,748,2020-07-18 21:00:00,4,-4,8
jquery,749,2020-07-25 21:00:00,170,-52,222
jquery,750,2020-08-01 21:00:00,0,0,0
jquery,751,2020-08-08 21:00:00,1,-2,3
jquery,752,2020-08-15 21:00:00,0,0,0
jquery,753,2020-08-22 21:00:00,100,-43,143
jquery,754,2020-08-29 21:00:00,48,-70,118
jquery,755,2020-09-05 21:00:00,0,0,0
jquery,756,2020-09-12 21:00:00,0,0,0
jquery,757,2020-09-19 21:00:00,168,-247,415
jquery,758,2020-09-26 21:00:00,1,-1,2
jquery,759,2020-10-03 21:00:00,0,0,0
jquery,760,2020-10-10 21:00:00,0,0,0
jquery,761,2020-10-17 21:00:00,34,-1,35
jquery,762,2020-10-24 21:00:00,0,0,0
jquery,763,2020-10-31 21:00:00,0,0,0
jquery,764,2020-11-07 21:00:00,7,-6,13
jquery,765,2020-11-14 21:00:00,0,0,0
jquery,766,2020-11-21 21:00:00,0,0,0
jquery,767,2020-11-28 21:00:00,0,0,0
jquery,768,2020-12-05 21:00:00,88,-10,98
jquery,769,2020-12-12 21:00:00,0,0,0
jquery,770,2020-12-19 21:00:00,0,0,0
jquery,771,2020-12-26 21:00:00,0,0,0
jquery,772,2021-01-02 21:00:00,0,0,0
jquery,773,2021-01-09 21:00:00,94,-36,130
jquery,774,2021-01-16 21:00:00,0,0,0
jquery,775,2021-01-23 21:00:00,25,-59,84
jquery,776,2021-01-30 21:00:00,13,-13,26
jquery,777,2021-02-06 21:00:00,0,0,0
jquery,778,2021-02-13 21:00:00,9,0,9
jquery,779,2021-02-20 21:00:00,0,0,0
jquery,780,2021-02-27 21:00:00,6,-7,13
jquery,781,2021-03-06 21:00:00,0,0,0
jquery,782,2021-03-13 21:00:00,0,0,0
jquery,783,2021-03-20 21:00:00,34,-11,45
jquery,784,2021-03-27 21:00:00,0,0,0
jquery,785,2021-04-03 21:00:00,0,0,0
jquery,786,2021-04-10 21:00:00,37,-23,60
jquery,787,2021-04-17 21:00:00,0,0,0
jquery,788,2021-04-24 21:00:00,0,0,0
jquery,789,2021-05-01 21:00:00,0,0,0
jquery,790,2021-05-08 21:00:00,20,-4,24
jquery,791,2021-05-15 21:00:00,0,0,0
jquery,792,2021-05-22 21:00:00,9,-19,28
jquery,793,2021-05-29 21:00:00,0,0,0
jquery,794,2021-06-05 21:00:00,0,0,0
jquery,795,2021-06-12 21:00:00,0,0,0
jquery,796,2021-06-19 21:00:00,0,0,0
jquery,797,2021-06-26 21:00:00,0,0,0
jquery,798,2021-07-03 21:00:00,0,0,0
jquery,799,2021-07-10 21:00:00,2,-2,4
jquery,800,2021-07-17 21:00:00,22,-12,34
jquery,801,2021-07-24 21:00:00,0,0,0
jquery,802,2021-07-31 21:00:00,0,0,0
jquery,803,2021-08-07 21:00:00,0,0,0
jquery,804,2021-08-14 21:00:00,0,0,0
jquery,805,2021-08-21 21:00:00,0,0,0
bootstrap,245,2016-01-02 21:00:00,1010,-1073,2083
bootstrap,246,2016-01-09 21:00:00,303,-200,503
bootstrap,247,2016-01-16 21:00:00,396,-162,558
bootstrap,248,2016-01-23 21:00:00,248,-224,472
bootstrap,249,2016-01-30 21:00:00,4388,-3500,7888
bootstrap,250,2016-02-06 21:00:00,647,-908,1555
bootstrap,251,2016-02-13 21:00:00,818,-674,1492
bootstrap,252,2016-02-20 21:00:00,104,-155,259
bootstrap,253,2016-02-27 21:00:00,107,-95,202
bootstrap,254,2016-03-05 21:00:00,187,-157,344
bootstrap,255,2016-03-12 21:00:00,323,-214,537
bootstrap,256,2016-03-19 21:00:00,1281,-1717,2998
bootstrap,257,2016-03-26 21:00:00,621,-593,1214
bootstrap,258,2016-04-02 21:00:00,109,-107,216
bootstrap,259,2016-04-09 21:00:00,170,-87,257
bootstrap,260,2016-04-16 21:00:00,73,-136,209
bootstrap,261,2016-04-23 21:00:00,65,-29,94
bootstrap,262,2016-04-30 21:00:00,10,-10,20
bootstrap,263,2016-05-07 21:00:00,1609,-1095,2704
bootstrap,264,2016-05-14 21:00:00,116,-26,142
bootstrap,265,2016-05-21 21:00:00,39,-61,100
bootstrap,266,2016-05-28 21:00:00,1886,-1730,3616
bootstrap,267,2016-06-04 21:00:00,41,-7725,7766
bootstrap,268,2016-06-11 21:00:00,19,-15,34
bootstrap,269,2016-06-18 21:00:00,1152,-237,1389
bootstrap,270,2016-06-25 21:00:00,486,-1547,2033
bootstrap,271,2016-07-02 21:00:00,135,-104,239
bootstrap,272,2016-07-09 21:00:00,2539,-1797,4336
bootstrap,273,2016-07-16 21:00:00,118,-541,659
bootstrap,274,2016-07-23 21:00:00,3058,-337,3395
bootstrap,275,2016-07-30 21:00:00,436,-92,528
bootstrap,276,2016-08-06 21:00:00,1,-2,3
bootstrap,277,2016-08-13 21:00:00,7,-14,21
bootstrap,278,2016-08-20 21:00:00,82,-125,207
bootstrap,279,2016-08-27 21:00:00,0,0,0
bootstrap,280,2016-09-03 21:00:00,1033,-869,1902
bootstrap,281,2016-09-10 21:00:00,17264,-127,17391
bootstrap,282,2016-09-17 21:00:00,10,0,10
bootstrap,283,2016-09-24 21:00:00,59,-59,118
bootstrap,284,2016-10-01 21:00:00,5921,-4207,10128
bootstrap,285,2016-10-08 21:00:00,5824,-7052,12876
bootstrap,286,2016-10-15 21:00:00,1378,-462,1840
bootstrap,287,2016-10-22 21:00:00,1873,-1169,3042
bootstrap,288,2016-10-29 21:00:00,7146,-786,7932
bootstrap,289,2016-11-05 21:00:00,205,-139,344
bootstrap,290,2016-11-12 21:00:00,1168,-1196,2364
bootstrap,291,2016-11-19 21:00:00,2759,-1767,4526
bootstrap,292,2016-11-26 21:00:00,2047,-2149,4196
bootstrap,293,2016-12-03 21:00:00,818,-1034,1852
bootstrap,294,2016-12-10 21:00:00,5,-3,8
bootstrap,295,2016-12-17 21:00:00,13198,-37585,50783
bootstrap,296,2016-12-24 21:00:00,4118,-4006,8124
bootstrap,297,2016-12-31 21:00:00,1124,-2010,3134
bootstrap,298,2017-01-07 21:00:00,100,-78,178
bootstrap,299,2017-01-14 21:00:00,1180,-1880,3060
bootstrap,300,2017-01-21 21:00:00,132,-149,281
bootstrap,301,2017-01-28 21:00:00,50,-25,75
bootstrap,302,2017-02-04 21:00:00,6966,-4860,11826
bootstrap,303,2017-02-11 21:00:00,10,-45,55
bootstrap,304,2017-02-18 21:00:00,56,-104,160
bootstrap,305,2017-02-25 21:00:00,260,-489,749
bootstrap,306,2017-03-04 21:00:00,179,-132,311
bootstrap,307,2017-03-11 21:00:00,876,-935,1811
bootstrap,308,2017-03-18 21:00:00,9992,-882,10874
bootstrap,309,2017-03-25 21:00:00,991,-758,1749
bootstrap,310,2017-04-01 21:00:00,2037,-2190,4227
bootstrap,311,2017-04-08 21:00:00,303,-269,572
bootstrap,312,2017-04-15 21:00:00,5865,-5799,11664
bootstrap,313,2017-04-22 21:00:00,346,-265,611
bootstrap,314,2017-04-29 21:00:00,82,-43,125
bootstrap,315,2017-05-06 21:00:00,88,-79,167
bootstrap,316,2017-05-13 21:00:00,1674,-677,2351
bootstrap,317,2017-05-20 21:00:00,2395,-1670,4065
bootstrap,318,2017-05-27 21:00:00,29734,-45039,74773
bootstrap,319,2017-06-03 21:00:00,620,-546,1166
bootstrap,320,2017-06-10 21:00:00,2014,-1508,3522
bootstrap,321,2017-06-17 21:00:00,1431,-1569,3000
bootstrap,322,2017-06-24 21:00:00,5460,-7998,13458
bootstrap,323,2017-07-01 21:00:00,1100,-624,1724
bootstrap,324,2017-07-08 21:00:00,304,-12448,12752
bootstrap,325,2017-07-15 21:00:00,7158,-2472,9630
bootstrap,326,2017-07-22 21:00:00,67,-116,183
bootstrap,327,2017-07-29 21:00:00,46,-102,148
bootstrap,328,2017-08-05 21:00:00,6002,-4584,10586
bootstrap,329,2017-08-12 21:00:00,1121,-943,2064
bootstrap,330,2017-08-19 21:00:00,2053,-931,2984
bootstrap,331,2017-08-26 21:00:00,346,-151,497
bootstrap,332,2017-09-02 21:00:00,12907,-6017,18924
bootstrap,333,2017-09-09 21:00:00,4295,-3475,7770
bootstrap,334,2017-09-16 21:00:00,3382,-3101,6483
bootstrap,335,2017-09-23 21:00:00,5544,-6099,11643
bootstrap,336,2017-09-30 21:00:00,3009,-1902,4911
bootstrap,337,2017-10-07 21:00:00,664,-376,1040
bootstrap,338,2017-10-14 21:00:00,1724,-1155,2879
bootstrap,339,2017-10-21 21:00:00,2687,-2452,5139
bootstrap,340,2017-10-28 21:00:00,1948,-1678,3626
bootstrap,341,2017-11-04 21:00:00,3295,-2595,5890
bootstrap,342,2017-11-11 21:00:00,208,-195,403
bootstrap,343,2017-11-18 21:00:00,907,-661,1568
bootstrap,344,2017-11-25 21:00:00,739,-234,973
bootstrap,345,2017-12-02 21:00:00,488,-488,976
bootstrap,346,2017-12-09 21:00:00,2609,-2395,5004
bootstrap,347,2017-12-16 21:00:00,5513,-2483,7996
bootstrap,348,2017-12-23 21:00:00,1710,-1097,2807
bootstrap,349,2017-12-30 21:00:00,1284,-608,1892
bootstrap,350,2018-01-06 21:00:00,2141,-1199,3340
bootstrap,351,2018-01-13 21:00:00,2764,-1925,4689
bootstrap,352,2018-01-20 21:00:00,1117,-594,1711
bootstrap,353,2018-01-27 21:00:00,73,-59,132
bootstrap,354,2018-02-03 21:00:00,1005,-859,1864
bootstrap,355,2018-02-10 21:00:00,296,-109,405
bootstrap,356,2018-02-17 21:00:00,529,-124,653
bootstrap,357,2018-02-24 21:00:00,1074,-492,1566
bootstrap,358,2018-03-03 21:00:00,2249,-1534,3783
bootstrap,359,2018-03-10 21:00:00,1682,-6687,8369
bootstrap,360,2018-03-17 21:00:00,3616,-3036,6652
bootstrap,361,2018-03-24 21:00:00,9019,-9176,18195
bootstrap,362,2018-03-31 21:00:00,143,-87,230
bootstrap,363,2018-04-07 21:00:00,20319,-19851,40170
bootstrap,364,2018-04-14 21:00:00,278,-378,656
bootstrap,365,2018-04-21 21:00:00,48,-13,61
bootstrap,366,2018-04-28 21:00:00,1347,-2916,4263
bootstrap,367,2018-05-05 21:00:00,2222,-2329,4551
bootstrap,368,2018-05-12 21:00:00,16,-5,21
bootstrap,369,2018-05-19 21:00:00,4579,-4810,9389
bootstrap,370,2018-05-26 21:00:00,192,-156,348
bootstrap,371,2018-06-02 21:00:00,3119,-2700,5819
bootstrap,372,2018-06-09 21:00:00,172,-59,231
bootstrap,373,2018-06-16 21:00:00,23263,-22925,46188
bootstrap,374,2018-06-23 21:00:00,1024,-64,1088
bootstrap,375,2018-06-30 21:00:00,2272,-3443,5715
bootstrap,376,2018-07-07 21:00:00,489,-309,798
bootstrap,377,2018-07-14 21:00:00,257,-202,459
bootstrap,378,2018-07-21 21:00:00,4999,-4328,9327
bootstrap,379,2018-07-28 21:00:00,2060,-321,2381
bootstrap,380,2018-08-04 21:00:00,37,-4,41
bootstrap,381,2018-08-11 21:00:00,2728,-2554,5282
bootstrap,382,2018-08-18 21:00:00,969,-377,1346
bootstrap,383,2018-08-25 21:00:00,706,-949,1655
bootstrap,384,2018-09-01 21:00:00,34,-31,65
bootstrap,385,2018-09-08 21:00:00,1374,-1598,2972
bootstrap,386,2018-09-15 21:00:00,634,-613,1247
bootstrap,387,2018-09-22 21:00:00,3161,-3306,6467
bootstrap,388,2018-09-29 21:00:00,722,-690,1412
bootstrap,389,2018-10-06 21:00:00,34,-58,92
bootstrap,390,2018-10-13 21:00:00,1270,-810,2080
bootstrap,391,2018-10-20 21:00:00,427,-659,1086
bootstrap,392,2018-10-27 21:00:00,392,-359,751
bootstrap,393,2018-11-03 21:00:00,2565,-3239,5804
bootstrap,394,2018-11-10 21:00:00,11517,-10222,21739
bootstrap,395,2018-11-17 21:00:00,823,-1176,1999
bootstrap,396,2018-11-24 21:00:00,123,-77,200
bootstrap,397,2018-12-01 21:00:00,635,-372,1007
bootstrap,398,2018-12-08 21:00:00,771,-363,1134
bootstrap,399,2018-12-15 21:00:00,21203,-21075,42278
bootstrap,400,2018-12-22 21:00:00,181,-179,360
bootstrap,401,2018-12-29 21:00:00,598,-836,1434
bootstrap,402,2019-01-05 21:00:00,23823,-23144,46967
bootstrap,403,2019-01-12 21:00:00,173,-166,339
bootstrap,404,2019-01-19 21:00:00,1236,-768,2004
bootstrap,405,2019-01-26 21:00:00,95,-50,145
bootstrap,406,2019-02-02 21:00:00,1318,-1067,2385
bootstrap,407,2019-02-09 21:00:00,22485,-21515,44000
bootstrap,408,2019-02-16 21:00:00,2425,-3098,5523
bootstrap,409,2019-02-23 21:00:00,7878,-5541,13419
bootstrap,410,2019-03-02 21:00:00,141,-109,250
bootstrap,411,2019-03-09 21:00:00,7094,-1905,8999
bootstrap,412,2019-03-16 21:00:00,789,-376,1165
bootstrap,413,2019-03-23 21:00:00,3989,-4136,8125
bootstrap,414,2019-03-30 21:00:00,1281,-1359,2640
bootstrap,415,2019-04-06 21:00:00,2084,-2094,4178
bootstrap,416,2019-04-13 21:00:00,2739,-2141,4880
bootstrap,417,2019-04-20 21:00:00,271,-99,370
bootstrap,418,2019-04-27 21:00:00,2511,-2435,4946
bootstrap,419,2019-05-04 21:00:00,5028,-5472,10500
bootstrap,420,2019-05-11 21:00:00,270,-203,473
bootstrap,421,2019-05-18 21:00:00,1291,-783,2074
bootstrap,422,2019-05-25 21:00:00,22,-18,40
bootstrap,423,2019-06-01 21:00:00,679,-965,1644
bootstrap,424,2019-06-08 21:00:00,8,-6,14
bootstrap,425,2019-06-15 21:00:00,606,-463,1069
bootstrap,426,2019-06-22 21:00:00,61,-28,89
bootstrap,427,2019-06-29 21:00:00,1152,-1220,2372
bootstrap,428,2019-07-06 21:00:00,11659,-10916,22575
bootstrap,429,2019-07-13 21:00:00,738,-443,1181
bootstrap,430,2019-07-20 21:00:00,6670,-2893,9563
bootstrap,431,2019-07-27 21:00:00,587,-447,1034
bootstrap,432,2019-08-03 21:00:00,336,-140,476
bootstrap,433,2019-08-10 21:00:00,1077,-473,1550
bootstrap,434,2019-08-17 21:00:00,340,-306,646
bootstrap,435,2019-08-24 21:00:00,1956,-3166,5122
bootstrap,436,2019-08-31 21:00:00,598,-438,1036
bootstrap,437,2019-09-07 21:00:00,226,-202,428
bootstrap,438,2019-09-14 21:00:00,1590,-1623,3213
bootstrap,439,2019-09-21 21:00:00,1558,-1136,2694
bootstrap,440,2019-09-28 21:00:00,13858,-13758,27616
bootstrap,441,2019-10-05 21:00:00,10179,-9890,20069
bootstrap,442,2019-10-12 21:00:00,650,-148,798
bootstrap,443,2019-10-19 21:00:00,605,-405,1010
bootstrap,444,2019-10-26 21:00:00,1056,-858,1914
bootstrap,445,2019-11-02 21:00:00,2178,-2053,4231
bootstrap,446,2019-11-09 21:00:00,197,-91,288
bootstrap,447,2019-11-16 21:00:00,579,-311,890
bootstrap,448,2019-11-23 21:00:00,1654,-1606,3260
bootstrap,449,2019-11-30 21:00:00,52,-37,89
bootstrap,450,2019-12-07 21:00:00,379,-386,765
bootstrap,451,2019-12-14 21:00:00,197,-298,495
bootstrap,452,2019-12-21 21:00:00,2238,-1536,3774
bootstrap,453,2019-12-28 21:00:00,149,-168,317
bootstrap,454,2020-01-04 21:00:00,1198,-959,2157
bootstrap,455,2020-01-11 21:00:00,2294,-2256,4550
bootstrap,456,2020-01-18 21:00:00,62,-47,109
bootstrap,457,2020-01-25 21:00:00,411,-604,1015
bootstrap,458,2020-02-01 21:00:00,912,-971,1883
bootstrap,459,2020-02-08 21:00:00,355,-299,654
bootstrap,460,2020-02-15 21:00:00,247,-291,538
bootstrap,461,2020-02-22 21:00:00,360,-194,554
bootstrap,462,2020-02-29 21:00:00,991,-1168,2159
bootstrap,463,2020-03-07 21:00:00,290,-512,802
bootstrap,464,2020-03-14 21:00:00,275,-237,512
bootstrap,465,2020-03-21 21:00:00,6349,-5835,12184
bootstrap,466,2020-03-28 21:00:00,1576,-1396,2972
bootstrap,467,2020-04-04 21:00:00,381,-523,904
bootstrap,468,2020-04-11 21:00:00,2129,-2399,4528
bootstrap,469,2020-04-18 21:00:00,99,-26,125
bootstrap,470,2020-04-25 21:00:00,711,-833,1544
bootstrap,471,2020-05-02 21:00:00,989,-1618,2607
bootstrap,472,2020-05-09 21:00:00,28746,-29535,58281
bootstrap,473,2020-05-16 21:00:00,304,-243,547
bootstrap,474,2020-05-23 21:00:00,146,-176,322
bootstrap,475,2020-05-30 21:00:00,2051,-1938,3989
bootstrap,476,2020-06-06 21:00:00,6011,-1886,7897
bootstrap,477,2020-06-13 21:00:00,1144,-1427,2571
bootstrap,478,2020-06-20 21:00:00,1294,-1204,2498
bootstrap,479,2020-06-27 21:00:00,319,-224,543
bootstrap,480,2020-07-04 21:00:00,1039,-926,1965
bootstrap,481,2020-07-11 21:00:00,212,-158,370
bootstrap,482,2020-07-18 21:00:00,882,-810,1692
bootstrap,483,2020-07-25 21:00:00,139,-100,239
bootstrap,484,2020-08-01 21:00:00,341,-174,515
bootstrap,485,2020-08-08 21:00:00,15,-30,45
bootstrap,486,2020-08-15 21:00:00,63,-59,122
bootstrap,487,2020-08-22 21:00:00,30,-30,60
bootstrap,488,2020-08-29 21:00:00,701,-894,1595
bootstrap,489,2020-09-05 21:00:00,922,-886,1808
bootstrap,490,2020-09-12 21:00:00,1481,-1274,2755
bootstrap,491,2020-09-19 21:00:00,856,-1374,2230
bootstrap,492,2020-09-26 21:00:00,850,-537,1387
bootstrap,493,2020-10-03 21:00:00,70,-64,134
bootstrap,494,2020-10-10 21:00:00,533,-528,1061
bootstrap,495,2020-10-17 21:00:00,2752,-2869,5621
bootstrap,496,2020-10-24 21:00:00,2472,-1721,4193
bootstrap,497,2020-10-31 21:00:00,1126,-1054,2180
bootstrap,498,2020-11-07 21:00:00,5268,-2730,7998
bootstrap,499,2020-11-14 21:00:00,323,-883,1206
bootstrap,500,2020-11-21 21:00:00,1616,-1340,2956
bootstrap,501,2020-11-28 21:00:00,24449,-3236,27685
bootstrap,502,2020-12-05 21:00:00,3178,-4178,7356
bootstrap,503,2020-12-12 21:00:00,602,-524,1126
bootstrap,504,2020-12-19 21:00:00,713,-702,1415
bootstrap,505,2020-12-26 21:00:00,95,-316,411
bootstrap,506,2021-01-02 21:00:00,505,-650,1155
bootstrap,507,2021-01-09 21:00:00,570,-492,1062
bootstrap,508,2021-01-16 21:00:00,579,-362,941
bootstrap,509,2021-01-23 21:00:00,199,-195,394
bootstrap,510,2021-01-30 21:00:00,450,-234,684
bootstrap,511,2021-02-06 21:00:00,5863,-4690,10553
bootstrap,512,2021-02-13 21:00:00,241,-144,385
bootstrap,513,2021-02-20 21:00:00,453,-355,808
bootstrap,514,2021-02-27 21:00:00,2352,-724,3076
bootstrap,515,2021-03-06 21:00:00,409,-650,1059
bootstrap,516,2021-03-13 21:00:00,777,-279,1056
bootstrap,517,2021-03-20 21:00:00,11230,-9593,20823
bootstrap,518,2021-03-27 21:00:00,574,-375,949
bootstrap,519,2021-04-03 21:00:00,172,-183,355
bootstrap,520,2021-04-10 21:00:00,942,-633,1575
bootstrap,521,2021-04-17 21:00:00,886,-482,1368
bootstrap,522,2021-04-24 21:00:00,1810,-1592,3402
bootstrap,523,2021-05-01 21:00:00,3011,-2561,5572
bootstrap,524,2021-05-08 21:00:00,5281,-5198,10479
bootstrap,525,2021-05-15 21:00:00,787,-538,1325
bootstrap,526,2021-05-22 21:00:00,315,-62,377
bootstrap,527,2021-05-29 21:00:00,1326,-619,1945
bootstrap,528,2021-06-05 21:00:00,423,-539,962
bootstrap,529,2021-06-12 21:00:00,902,-783,1685
bootstrap,530,2021-06-19 21:00:00,4825,-2897,7722
bootstrap,531,2021-06-26 21:00:00,176,-99,275
bootstrap,532,2021-07-03 21:00:00,281,-110,391
bootstrap,533,2021-07-10 21:00:00,191,-251,442
bootstrap,534,2021-07-17 21:00:00,489,-268,757
bootstrap,535,2021-07-24 21:00:00,969,-400,1369
bootstrap,536,2021-07-31 21:00:00,36611,-34857,71468
bootstrap,537,2021-08-07 21:00:00,244,-156,400
bootstrap,538,2021-08-14 21:00:00,14,-33,47
bootstrap,539,2021-08-21 21:00:00,61,-36,97
compose,108,2016-01-02 21:00:00,753,-284,1037
compose,109,2016-01-09 21:00:00,2589,-1460,4049
compose,110,2016-01-16 21:00:00,3160,-1002,4162
compose,111,2016-01-23 21:00:00,4384,-2932,7316
compose,112,2016-01-30 21:00:00,1657,-1206,2863
compose,113,2016-02-06 21:00:00,982,-393,1375
compose,114,2016-02-13 21:00:00,1174,-566,1740
compose,115,2016-02-20 21:00:00,899,-344,1243
compose,116,2016-02-27 21:00:00,941,-658,1599
compose,117,2016-03-05 21:00:00,978,-582,1560
compose,118,2016-03-12 21:00:00,425,-193,618
compose,119,2016-03-19 21:00:00,533,-182,715
compose,120,2016-03-26 21:00:00,169,-119,288
compose,121,2016-04-02 21:00:00,708,-470,1178
compose,122,2016-04-09 21:00:00,458,-102,560
compose,123,2016-04-16 21:00:00,355,-65,420
compose,124,2016-04-23 21:00:00,304,-96,400
compose,125,2016-04-30 21:00:00,48,-7,55
compose,126,2016-05-07 21:00:00,318,-26,344
compose,127,2016-05-14 21:00:00,208,-25,233
compose,128,2016-05-21 21:00:00,85,-46,131
compose,129,2016-05-28 21:00:00,87,-61,148
compose,130,2016-06-04 21:00:00,82,-22,104
compose,131,2016-06-11 21:00:00,1014,-122,1136
compose,132,2016-06-18 21:00:00,166,-8,174
compose,133,2016-06-25 21:00:00,729,-93,822
compose,134,2016-07-02 21:00:00,293,-75,368
compose,135,2016-07-09 21:00:00,244,-39,283
compose,136,2016-07-16 21:00:00,93,-27,120
compose,137,2016-07-23 21:00:00,736,-340,1076
compose,138,2016-07-30 21:00:00,64,-19,83
compose,139,2016-08-06 21:00:00,166,-17,183
compose,140,2016-08-13 21:00:00,13,-11,24
compose,141,2016-08-20 21:00:00,9,-1,10
compose,142,2016-08-27 21:00:00,0,0,0
compose,143,2016-09-03 21:00:00,196,-96,292
compose,144,2016-09-10 21:00:00,154,-12,166
compose,145,2016-09-17 21:00:00,80,-11,91
compose,146,2016-09-24 21:00:00,388,-54,442
compose,147,2016-10-01 21:00:00,216,-4739,4955
compose,148,2016-10-08 21:00:00,201,-57,258
compose,149,2016-10-15 21:00:00,237,-34,271
compose,150,2016-10-22 21:00:00,80,-36,116
compose,151,2016-10-29 21:00:00,248,-49,297
compose,152,2016-11-05 21:00:00,738,-38,776
compose,153,2016-11-12 21:00:00,293,-28,321
compose,154,2016-11-19 21:00:00,80,-25,105
compose,155,2016-11-26 21:00:00,25,0,25
compose,156,2016-12-03 21:00:00,124,-45,169
compose,157,2016-12-10 21:00:00,52,-5,57
compose,158,2016-12-17 21:00:00,233,-22,255
compose,159,2016-12-24 21:00:00,428,-2,430
compose,160,2016-12-31 21:00:00,417,-128,545
compose,161,2017-01-07 21:00:00,190,-32,222
compose,162,2017-01-14 21:00:00,283,-73,356
compose,163,2017-01-21 21:00:00,292,-20,312
compose,164,2017-01-28 21:00:00,209,-47,256
compose,165,2017-02-04 21:00:00,374,-53,427
compose,166,2017-02-11 21:00:00,339,-181,520
compose,167,2017-02-18 21:00:00,140,-21,161
compose,168,2017-02-25 21:00:00,476,-144,620
compose,169,2017-03-04 21:00:00,358,-153,511
compose,170,2017-03-11 21:00:00,880,-100,980
compose,171,2017-03-18 21:00:00,343,-120,463
compose,172,2017-03-25 21:00:00,44,-14,58
compose,173,2017-04-01 21:00:00,657,-31,688
compose,174,2017-04-08 21:00:00,143,-23,166
compose,175,2017-04-15 21:00:00,673,-324,997
compose,176,2017-04-22 21:00:00,282,-36,318
compose,177,2017-04-29 21:00:00,101,-13,114
compose,178,2017-05-06 21:00:00,201,-61,262
compose,179,2017-05-13 21:00:00,171,-27,198
compose,180,2017-05-20 21:00:00,2168,-400,2568
compose,181,2017-05-27 21:00:00,48,-10,58
compose,182,2017-06-03 21:00:00,618,-174,792
compose,183,2017-06-10 21:00:00,316,-24,340
compose,184,2017-06-17 21:00:00,291,-89,380
compose,185,2017-06-24 21:00:00,52,-44,96
compose,186,2017-07-01 21:00:00,382,-180,562
compose,187,2017-07-08 21:00:00,995,-13,1008
compose,188,2017-07-15 21:00:00,212,-108,320
compose,189,2017-07-22 21:00:00,104,-26,130
compose,190,2017-07-29 21:00:00,184,-46,230
compose,191,2017-08-05 21:00:00,2247,-177,2424
compose,192,2017-08-12 21:00:00,1800,-22,1822
compose,193,2017-08-19 21:00:00,1348,-1140,2488
compose,194,2017-08-26 21:00:00,359,-148,507
compose,195,2017-09-02 21:00:00,0,0,0
compose,196,2017-09-09 21:00:00,0,0,0
compose,197,2017-09-16 21:00:00,82,-25,107
compose,198,2017-09-23 21:00:00,1941,-1722,3663
compose,199,2017-09-30 21:00:00,88,-16,104
compose,200,2017-10-07 21:00:00,691,-157,848
compose,201,2017-10-14 21:00:00,1271,-222,1493
compose,202,2017-10-21 21:00:00,418,-150,568
compose,203,2017-10-28 21:00:00,176,-68,244
compose,204,2017-11-04 21:00:00,378,-106,484
compose,205,2017-11-11 21:00:00,242,-80,322
compose,206,2017-11-18 21:00:00,116,-18,134
compose,207,2017-11-25 21:00:00,622,-168,790
compose,208,2017-12-02 21:00:00,1406,-289,1695
compose,209,2017-12-09 21:00:00,307,-132,439
compose,210,2017-12-16 21:00:00,109,-51,160
compose,211,2017-12-23 21:00:00,0,0,0
compose,212,2017-12-30 21:00:00,1148,-1108,2256
compose,213,2018-01-06 21:00:00,340,-285,625
compose,214,2018-01-13 21:00:00,356,-139,495
compose,215,2018-01-20 21:00:00,544,-195,739
compose,216,2018-01-27 21:00:00,863,-151,1014
compose,217,2018-02-03 21:00:00,224,-47,271
compose,218,2018-02-10 21:00:00,155,-29,184
compose,219,2018-02-17 21:00:00,477,-61,538
compose,220,2018-02-24 21:00:00,314,-107,421
compose,221,2018-03-03 21:00:00,887,-185,1072
compose,222,2018-03-10 21:00:00,387,-93,480
compose,223,2018-03-17 21:00:00,134,-35,169
compose,224,2018-03-24 21:00:00,300,-66,366
compose,225,2018-03-31 21:00:00,80,-12,92
compose,226,2018-04-07 21:00:00,84,-118,202
compose,227,2018-04-14 21:00:00,2083,-264,2347
compose,228,2018-04-21 21:00:00,1134,-877,2011
compose,229,2018-04-28 21:00:00,243,-31,274
compose,230,2018-05-05 21:00:00,12,-4,16
compose,231,2018-05-12 21:00:00,1,-1,2
compose,232,2018-05-19 21:00:00,46,-21,67
compose,233,2018-05-26 21:00:00,617,-2,619
compose,234,2018-06-02 21:00:00,7,0,7
compose,235,2018-06-09 21:00:00,3,-3,6
compose,236,2018-06-16 21:00:00,139,-19,158
compose,237,2018-06-23 21:00:00,4,-4,8
compose,238,2018-06-30 21:00:00,45,-20,65
compose,239,2018-07-07 21:00:00,378,-118,496
compose,240,2018-07-14 21:00:00,72,-39,111
compose,241,2018-07-21 21:00:00,4,-3,7
compose,242,2018-07-28 21:00:00,50,-2,52
compose,243,2018-08-04 21:00:00,106,-37,143
compose,244,2018-08-11 21:00:00,231,-175,406
compose,245,2018-08-18 21:00:00,0,0,0
compose,246,2018-08-25 21:00:00,178,-165,343
compose,247,2018-09-01 21:00:00,11,-45,56
compose,248,2018-09-08 21:00:00,42,-105,147
compose,249,2018-09-15 21:00:00,84,-70,154
compose,250,2018-09-22 21:00:00,286,-50,336
compose,251,2018-09-29 21:00:00,227,-144,371
compose,252,2018-10-06 21:00:00,136,-88,224
compose,253,2018-10-13 21:00:00,305,-66,371
compose,254,2018-10-20 21:00:00,36,-16,52
compose,255,2018-10-27 21:00:00,165,-29,194
compose,256,2018-11-03 21:00:00,52,-7,59
compose,257,2018-11-10 21:00:00,34,-4,38
compose,258,2018-11-17 21:00:00,218,-40,258
compose,259,2018-11-24 21:00:00,359,-145,504
compose,260,2018-12-01 21:00:00,69,-25,94
compose,261,2018-12-08 21:00:00,278,-27,305
compose,262,2018-12-15 21:00:00,12,-6,18
compose,263,2018-12-22 21:00:00,0,0,0
compose,264,2018-12-29 21:00:00,0,0,0
compose,265,2019-01-05 21:00:00,191,-59,250
compose,266,2019-01-12 21:00:00,104,-17,121
compose,267,2019-01-19 21:00:00,4,-2,6
compose,268,2019-01-26 21:00:00,80,-80,160
compose,269,2019-02-02 21:00:00,81,-23,104
compose,270,2019-02-09 21:00:00,24,-22,46
compose,271,2019-02-16 21:00:00,95,-18,113
compose,272,2019-02-23 21:00:00,63,-9,72
compose,273,2019-03-02 21:00:00,96,-35,131
compose,274,2019-03-09 21:00:00,154,-14,168
compose,275,2019-03-16 21:00:00,181,-24,205
compose,276,2019-03-23 21:00:00,5,-5,10
compose,277,2019-03-30 21:00:00,43,-34,77
compose,278,2019-04-06 21:00:00,299,-161,460
compose,279,2019-04-13 21:00:00,8,-4,12
compose,280,2019-04-20 21:00:00,1,-40,41
compose,281,2019-04-27 21:00:00,0,0,0
compose,282,2019-05-04 21:00:00,0,0,0
compose,283,2019-05-11 21:00:00,74,-71,145
compose,284,2019-05-18 21:00:00,147,-46,193
compose,285,2019-05-25 21:00:00,28,-53,81
compose,286,2019-06-01 21:00:00,23,-10,33
compose,287,2019-06-08 21:00:00,28,0,28
compose,288,2019-06-15 21:00:00,25,-31,56
compose,289,2019-06-22 21:00:00,9,-2,11
compose,290,2019-06-29 21:00:00,25,-25,50
compose,291,2019-07-06 21:00:00,40,-29,69
compose,292,2019-07-13 21:00:00,232,-211,443
compose,293,2019-07-20 21:00:00,82,-2,84
compose,294,2019-07-27 21:00:00,34,-3,37
compose,295,2019-08-03 21:00:00,73,-2,75
compose,296,2019-08-10 21:00:00,0,0,0
compose,297,2019-08-17 21:00:00,24,-17,41
compose,298,2019-08-24 21:00:00,425,-283,708
compose,299,2019-08-31 21:00:00,18,-1,19
compose,300,2019-09-07 21:00:00,85,-1,86
compose,301,2019-09-14 21:00:00,5,-2,7
compose,302,2019-09-21 21:00:00,6,-5,11
compose,303,2019-09-28 21:00:00,18,-9,27
compose,304,2019-10-05 21:00:00,161,-27,188
compose,305,2019-10-12 21:00:00,95,-54,149
compose,306,2019-10-19 21:00:00,1,-1,2
compose,307,2019-10-26 21:00:00,172,-5,177
compose,308,2019-11-02 21:00:00,129,-10,139
compose,309,2019-11-09 21:00:00,0,0,0
compose,310,2019-11-16 21:00:00,318,-577,895
compose,311,2019-11-23 21:00:00,123,-48,171
compose,312,2019-11-30 21:00:00,871,-1133,2004
compose,313,2019-12-07 21:00:00,55,-23,78
compose,314,2019-12-14 21:00:00,0,0,0
compose,315,2019-12-21 21:00:00,0,0,0
compose,316,2019-12-28 21:00:00,0,0,0
compose,317,2020-01-04 21:00:00,133,-1512,1645
compose,318,2020-01-11 21:00:00,39,-42,81
compose,319,2020-01-18 21:00:00,13,-11,24
compose,320,2020-01-25 21:00:00,153,-41,194
compose,321,2020-02-01 21:00:00,1874,-227,2101
compose,322,2020-02-08 21:00:00,4,-1,5
compose,323,2020-02-15 21:00:00,1,-1,2
compose,324,2020-02-22 21:00:00,604,-388,992
compose,325,2020-02-29 21:00:00,10,0,10
compose,326,2020-03-07 21:00:00,7,-6,13
compose,327,2020-03-14 21:00:00,0,0,0
compose,328,2020-03-21 21:00:00,18,0,18
compose,329,2020-03-28 21:00:00,0,0,0
compose,330,2020-04-04 21:00:00,2,-2,4
compose,331,2020-04-11 21:00:00,67,-2,69
compose,332,2020-04-18 21:00:00,15,-46,61
compose,333,2020-04-25 21:00:00,180,-3,183
compose,334,2020-05-02 21:00:00,37,-18,55
compose,335,2020-05-09 21:00:00,112,-35,147
compose,336,2020-05-16 21:00:00,10,-10,20
compose,337,2020-05-23 21:00:00,3,-3,6
compose,338,2020-05-30 21:00:00,55,-24,79
compose,339,2020-06-06 21:00:00,5,-2,7
compose,340,2020-06-13 21:00:00,160,-19,179
compose,341,2020-06-20 21:00:00,1604,-8790,10394
compose,342,2020-06-27 21:00:00,34,-18,52
compose,343,2020-07-04 21:00:00,1618,-1960,3578
compose,344,2020-07-11 21:00:00,4,-1,5
compose,345,2020-07-18 21:00:00,0,0,0
compose,346,2020-07-25 21:00:00,1,-1,2
compose,347,2020-08-01 21:00:00,10,-53,63
compose,348,2020-08-08 21:00:00,202,-28,230
compose,349,2020-08-15 21:00:00,60,-50,110
compose,350,2020-08-22 21:00:00,1,-1,2
compose,351,2020-08-29 21:00:00,22,-12,34
compose,352,2020-09-05 21:00:00,139,-38,177
compose,353,2020-09-12 21:00:00,89,-50,139
compose,354,2020-09-19 21:00:00,50,-19,69
compose,355,2020-09-26 21:00:00,0,0,0
compose,356,2020-10-03 21:00:00,0,0,0
compose,357,2020-10-10 21:00:00,3,-1,4
compose,358,2020-10-17 21:00:00,967,-809,1776
compose,359,2020-10-24 21:00:00,1,-1,2
compose,360,2020-10-31 21:00:00,97,-69,166
compose,361,2020-11-07 21:00:00,3,-3,6
compose,362,2020-11-14 21:00:00,203,-13,216
compose,363,2020-11-21 21:00:00,26,-7,33
compose,364,2020-11-28 21:00:00,108,-88,196
compose,365,2020-12-05 21:00:00,366,-36,402
compose,366,2020-12-12 21:00:00,0,0,0
compose,367,2020-12-19 21:00:00,32,-10,42
compose,368,2020-12-26 21:00:00,0,0,0
compose,369,2021-01-02 21:00:00,13,-4,17
compose,370,2021-01-09 21:00:00,0,0,0
compose,371,2021-01-16 21:00:00,277,-72,349
compose,372,2021-01-23 21:00:00,44,-84,128
compose,373,2021-01-30 21:00:00,3,-3,6
compose,374,2021-02-06 21:00:00,8,-3,11
compose,375,2021-02-13 21:00:00,201,-27,228
compose,376,2021-02-20 21:00:00,20,-9,29
compose,377,2021-02-27 21:00:00,21,-4,25
compose,378,2021-03-06 21:00:00,56,-14,70
compose,379,2021-03-13 21:00:00,10,-4,14
compose,380,2021-03-20 21:00:00,20,-1,21
compose,381,2021-03-27 21:00:00,116,-1,117
compose,382,2021-04-03 21:00:00,100,-57,157
compose,383,2021-04-10 21:00:00,32,-127,159
compose,384,2021-04-17 21:00:00,0,0,0
compose,385,2021-04-24 21:00:00,28,0,28
compose,386,2021-05-01 21:00:00,0,-3,3
compose,387,2021-05-08 21:00:00,24,-4,28
compose,388,2021-05-15 21:00:00,0,0,0
compose,389,2021-05-22 21:00:00,0,0,0
compose,390,2021-05-29 21:00:00,1,-1,2
compose,391,2021-06-05 21:00:00,0,0,0
compose,392,2021-06-12 21:00:00,10,-6,16
compose,393,2021-06-19 21:00:00,0,0,0
compose,394,2021-06-26 21:00:00,0,0,0
compose,395,2021-07-03 21:00:00,0,0,0
compose,396,2021-07-10 21:00:00,0,0,0
compose,397,2021-07-17 21:00:00,0,0,0
compose,398,2021-07-24 21:00:00,0,0,0
compose,399,2021-07-31 21:00:00,0,0,0
compose,400,2021-08-07 21:00:00,0,0,0
compose,401,2021-08-14 21:00:00,0,0,0
compose,402,2021-08-21 21:00:00,0,0,0
node,359,2016-01-02 21:00:00,946,-282,1228
node,360,2016-01-09 21:00:00,191532,-184245,375777
node,361,2016-01-16 21:00:00,234636,-199751,434387
node,362,2016-01-23 21:00:00,97138,-57107,154245
node,363,2016-01-30 21:00:00,7427,-4202,11629
node,364,2016-02-06 21:00:00,3829,-582,4411
node,365,2016-02-13 21:00:00,118704,-130361,249065
node,366,2016-02-20 21:00:00,10307,-7627,17934
node,367,2016-02-27 21:00:00,182596,-186593,369189
node,368,2016-03-05 21:00:00,1932,-3130,5062
node,369,2016-03-12 21:00:00,3250,-2070,5320
node,370,2016-03-19 21:00:00,5888,-455,6343
node,371,2016-03-26 21:00:00,25202,-20637,45839
node,372,2016-04-02 21:00:00,607573,-104323,711896
node,373,2016-04-09 21:00:00,4248,-2129,6377
node,374,2016-04-16 21:00:00,28894,-27248,56142
node,375,2016-04-23 21:00:00,39348,-42209,81557
node,376,2016-04-30 21:00:00,185878,-45688,231566
node,377,2016-05-07 21:00:00,2970,-1294,4264
node,378,2016-05-14 21:00:00,3969,-1641,5610
node,379,2016-05-21 21:00:00,374437,-132691,507128
node,380,2016-05-28 21:00:00,9181,-3711,12892
node,381,2016-06-04 21:00:00,2049,-1145,3194
node,382,2016-06-11 21:00:00,5800,-11434,17234
node,383,2016-06-18 21:00:00,18203,-18415,36618
node,384,2016-06-25 21:00:00,5934,-3040,8974
node,385,2016-07-02 21:00:00,11484,-11292,22776
node,386,2016-07-09 21:00:00,4581,-6082,10663
node,387,2016-07-16 21:00:00,48843,-46625,95468
node,388,2016-07-23 21:00:00,1233,-4288,5521
node,389,2016-07-30 21:00:00,23437,-11342,34779
node,390,2016-08-06 21:00:00,9165,-9067,18232
node,391,2016-08-13 21:00:00,1739,-1087,2826
node,392,2016-08-20 21:00:00,10141,-9838,19979
node,393,2016-08-27 21:00:00,1653,-335,1988
node,394,2016-09-03 21:00:00,300359,-182600,482959
node,395,2016-09-10 21:00:00,2527,-1446,3973
node,396,2016-09-17 21:00:00,81317,-73405,154722
node,397,2016-09-24 21:00:00,40374,-39357,79731
node,398,2016-10-01 21:00:00,22234,-21965,44199
node,399,2016-10-08 21:00:00,42674,-25683,68357
node,400,2016-10-15 21:00:00,20500,-13854,34354
node,401,2016-10-22 21:00:00,11199,-8984,20183
node,402,2016-10-29 21:00:00,3640,-5168,8808
node,403,2016-11-05 21:00:00,2513,-13177,15690
node,404,2016-11-12 21:00:00,1112,-845,1957
node,405,2016-11-19 21:00:00,6765,-1801,8566
node,406,2016-11-26 21:00:00,3633,-2209,5842
node,407,2016-12-03 21:00:00,2441,-680,3121
node,408,2016-12-10 21:00:00,7133,-1454,8587
node,409,2016-12-17 21:00:00,170390,-85901,256291
node,410,2016-12-24 21:00:00,25617,-15389,41006
node,411,2016-12-31 21:00:00,22161,-540,22701
node,412,2017-01-07 21:00:00,14617,-14498,29115
node,413,2017-01-14 21:00:00,6086,-46759,52845
node,414,2017-01-21 21:00:00,45586,-63044,108630
node,415,2017-01-28 21:00:00,6364,-3172,9536
node,416,2017-02-04 21:00:00,3317,-11675,14992
node,417,2017-02-11 21:00:00,106363,-80062,186425
node,418,2017-02-18 21:00:00,3350,-1076,4426
node,419,2017-02-25 21:00:00,1769,-1784,3553
node,420,2017-03-04 21:00:00,6500,-2868,9368
node,421,2017-03-11 21:00:00,4846,-1592,6438
node,422,2017-03-18 21:00:00,136133,-114569,250702
node,423,2017-03-25 21:00:00,27577,-13404,40981
node,424,2017-04-01 21:00:00,5422,-5017,10439
node,425,2017-04-08 21:00:00,138507,-95192,233699
node,426,2017-04-15 21:00:00,42623,-5911,48534
node,427,2017-04-22 21:00:00,6843,-5528,12371
node,428,2017-04-29 21:00:00,80722,-50874,131596
node,429,2017-05-06 21:00:00,80938,-33894,114832
node,430,2017-05-13 21:00:00,2237,-1051,3288
node,431,2017-05-20 21:00:00,44576,-41422,85998
node,432,2017-05-27 21:00:00,17839,-8468,26307
node,433,2017-06-03 21:00:00,120328,-75307,195635
node,434,2017-06-10 21:00:00,46630,-49448,96078
node,435,2017-06-17 21:00:00,13640,-12722,26362
node,436,2017-06-24 21:00:00,4521,-3176,7697
node,437,2017-07-01 21:00:00,11253,-23854,35107
node,438,2017-07-08 21:00:00,88420,-45598,134018
node,439,2017-07-15 21:00:00,59929,-3748,63677
node,440,2017-07-22 21:00:00,6630,-5634,12264
node,441,2017-07-29 21:00:00,70557,-49181,119738
node,442,2017-08-05 21:00:00,6943,-2955,9898
node,443,2017-08-12 21:00:00,3919,-3705,7624
node,444,2017-08-19 21:00:00,4131,-2102,6233
node,445,2017-08-26 21:00:00,5388,-2407,7795
node,446,2017-09-02 21:00:00,9116,-3269,12385
node,447,2017-09-09 21:00:00,135975,-264431,400406
node,448,2017-09-16 21:00:00,39476,-11627,51103
node,449,2017-09-23 21:00:00,3714,-1592,5306
node,450,2017-09-30 21:00:00,7646,-3232,10878
node,451,2017-10-07 21:00:00,11093,-28295,39388
node,452,2017-10-14 21:00:00,72012,-105695,177707
node,453,2017-10-21 21:00:00,122840,-45376,168216
node,454,2017-10-28 21:00:00,52023,-49104,101127
node,455,2017-11-04 21:00:00,6634,-2789,9423
node,456,2017-11-11 21:00:00,7397,-6181,13578
node,457,2017-11-18 21:00:00,10632,-22838,33470
node,458,2017-11-25 21:00:00,3220,-1783,5003
node,459,2017-12-02 21:00:00,131919,-93606,225525
node,460,2017-12-09 21:00:00,6942,-4959,11901
node,461,2017-12-16 21:00:00,375299,-280499,655798
node,462,2017-12-23 21:00:00,3378,-2413,5791
node,463,2017-12-30 21:00:00,3550,-1472,5022
node,464,2018-01-06 21:00:00,9971,-4289,14260
node,465,2018-01-13 21:00:00,5634,-2301,7935
node,466,2018-01-20 21:00:00,109253,-93884,203137
node,467,2018-01-27 21:00:00,4756,-3217,7973
node,468,2018-02-03 21:00:00,5093,-4722,9815
node,469,2018-02-10 21:00:00,4967,-3244,8211
node,470,2018-02-17 21:00:00,3486,-3012,6498
node,471,2018-02-24 21:00:00,5131,-2200,7331
node,472,2018-03-03 21:00:00,84225,-630703,714928
node,473,2018-03-10 21:00:00,11297,-19634,30931
node,474,2018-03-17 21:00:00,20202,-12066,32268
node,475,2018-03-24 21:00:00,1718083,-421707,2139790
node,476,2018-03-31 21:00:00,182356,-179343,361699
node,477,2018-04-07 21:00:00,73209,-56465,129674
node,478,2018-04-14 21:00:00,275657,-299477,575134
node,479,2018-04-21 21:00:00,4857,-3278,8135
node,480,2018-04-28 21:00:00,39513,-4139,43652
node,481,2018-05-05 21:00:00,3125,-1468,4593
node,482,2018-05-12 21:00:00,7818,-4834,12652
node,483,2018-05-19 21:00:00,2225,-1779,4004
node,484,2018-05-26 21:00:00,98374,-47689,146063
node,485,2018-06-02 21:00:00,3847,-1484,5331
node,486,2018-06-09 21:00:00,4338,-1424,5762
node,487,2018-06-16 21:00:00,186821,-53612,240433
node,488,2018-06-23 21:00:00,3239,-818,4057
node,489,2018-06-30 21:00:00,3838,-24344,28182
node,490,2018-07-07 21:00:00,25250,-28220,53470
node,491,2018-07-14 21:00:00,43351,-75645,118996
node,492,2018-07-21 21:00:00,112141,-57195,169336
node,493,2018-07-28 21:00:00,14440,-8606,23046
node,494,2018-08-04 21:00:00,7007,-3551,10558
node,495,2018-08-11 21:00:00,16534,-7139,23673
node,496,2018-08-18 21:00:00,12377,-11372,23749
node,497,2018-08-25 21:00:00,35625,-44114,79739
node,498,2018-09-01 21:00:00,208966,-203781,412747
node,499,2018-09-08 21:00:00,5186,-2532,7718
node,500,2018-09-15 21:00:00,80443,-76235,156678
node,501,2018-09-22 21:00:00,4727,-3319,8046
node,502,2018-09-29 21:00:00,2944,-2819,5763
node,503,2018-10-06 21:00:00,9537,-9898,19435
node,504,2018-10-13 21:00:00,22898,-11734,34632
node,505,2018-10-20 21:00:00,10824,-12842,23666
node,506,2018-10-27 21:00:00,20128,-13842,33970
node,507,2018-11-03 21:00:00,7070,-4381,11451
node,508,2018-11-10 21:00:00,13889,-11500,25389
node,509,2018-11-17 21:00:00,1735266,-206316,1941582
node,510,2018-11-24 21:00:00,10872,-6884,17756
node,511,2018-12-01 21:00:00,138497,-72296,210793
node,512,2018-12-08 21:00:00,2715,-1499,4214
node,513,2018-12-15 21:00:00,7110,-7288,14398
node,514,2018-12-22 21:00:00,3018,-2179,5197
node,515,2018-12-29 21:00:00,2491,-1863,4354
node,516,2019-01-05 21:00:00,5569,-2398,7967
node,517,2019-01-12 21:00:00,7556,-4695,12251
node,518,2019-01-19 21:00:00,3118,-2167,5285
node,519,2019-01-26 21:00:00,94018,-55461,149479
node,520,2019-02-02 21:00:00,2957,-1755,4712
node,521,2019-02-09 21:00:00,8311,-5147,13458
node,522,2019-02-16 21:00:00,3806,-2057,5863
node,523,2019-02-23 21:00:00,63624,-35767,99391
node,524,2019-03-02 21:00:00,23517,-45283,68800
node,525,2019-03-09 21:00:00,331351,-253233,584584
node,526,2019-03-16 21:00:00,5182,-3864,9046
node,527,2019-03-23 21:00:00,16458,-12933,29391
node,528,2019-03-30 21:00:00,9113,-3713,12826
node,529,2019-04-06 21:00:00,18949,-15540,34489
node,530,2019-04-13 21:00:00,31335,-33025,64360
node,531,2019-04-20 21:00:00,35082,-28728,63810
node,532,2019-04-27 21:00:00,2147,-1000,3147
node,533,2019-05-04 21:00:00,1590,-445,2035
node,534,2019-05-11 21:00:00,34162,-65357,99519
node,535,2019-05-18 21:00:00,11874,-2788,14662
node,536,2019-05-25 21:00:00,106553,-29214,135767
node,537,2019-06-01 21:00:00,2707,-1724,4431
node,538,2019-06-08 21:00:00,67902,-29011,96913
node,539,2019-06-15 21:00:00,2540,-846,3386
node,540,2019-06-22 21:00:00,2547,-2625,5172
node,541,2019-06-29 21:00:00,21286,-13040,34326
node,542,2019-07-06 21:00:00,6257,-5987,12244
node,543,2019-07-13 21:00:00,3462,-1247,4709
node,544,2019-07-20 21:00:00,169191,-32185,201376
node,545,2019-07-27 21:00:00,454928,-399289,854217
node,546,2019-08-03 21:00:00,4652,-1028,5680
node,547,2019-08-10 21:00:00,92942,-95144,188086
node,548,2019-08-17 21:00:00,2629,-823,3452
node,549,2019-08-24 21:00:00,6651,-5862,12513
node,550,2019-08-31 21:00:00,17971,-3571,21542
node,551,2019-09-07 21:00:00,45246,-16735,61981
node,552,2019-09-14 21:00:00,2980,-9938,12918
node,553,2019-09-21 21:00:00,52719,-28166,80885
node,554,2019-09-28 21:00:00,4993,-2030,7023
node,555,2019-10-05 21:00:00,5416,-2850,8266
node,556,2019-10-12 21:00:00,3059,-1019,4078
node,557,2019-10-19 21:00:00,5155,-4016,9171
node,558,2019-10-26 21:00:00,18828,-13429,32257
node,559,2019-11-02 21:00:00,94232,-59286,153518
node,560,2019-11-09 21:00:00,6428,-5660,12088
node,561,2019-11-16 21:00:00,14542,-11912,26454
node,562,2019-11-23 21:00:00,2719,-1265,3984
node,563,2019-11-30 21:00:00,4261,-1856,6117
node,564,2019-12-07 21:00:00,75502,-3500,79002
node,565,2019-12-14 21:00:00,2832,-7968,10800
node,566,2019-12-21 21:00:00,4823,-4525,9348
node,567,2019-12-28 21:00:00,2532,-1369,3901
node,568,2020-01-04 21:00:00,21849,-46703,68552
node,569,2020-01-11 21:00:00,2592,-3787,6379
node,570,2020-01-18 21:00:00,49244,-2981,52225
node,571,2020-01-25 21:00:00,6848,-4803,11651
node,572,2020-02-01 21:00:00,3236,-1321,4557
node,573,2020-02-08 21:00:00,6607,-5737,12344
node,574,2020-02-15 21:00:00,1933,-875,2808
node,575,2020-02-22 21:00:00,19124,-19746,38870
node,576,2020-02-29 21:00:00,128968,-152715,281683
node,577,2020-03-07 21:00:00,8527,-2807,11334
node,578,2020-03-14 21:00:00,242801,-174677,417478
node,579,2020-03-21 21:00:00,18932,-9713,28645
node,580,2020-03-28 21:00:00,1686,-1379,3065
node,581,2020-04-04 21:00:00,29195,-25275,54470
node,582,2020-04-11 21:00:00,3454,-2610,6064
node,583,2020-04-18 21:00:00,27277,-13319,40596
node,584,2020-04-25 21:00:00,4043,-1336,5379
node,585,2020-05-02 21:00:00,103468,-37045,140513
node,586,2020-05-09 21:00:00,15360,-6279,21639
node,587,2020-05-16 21:00:00,5612,-1973,7585
node,588,2020-05-23 21:00:00,2161,-984,3145
node,589,2020-05-30 21:00:00,4524,-11593,16117
node,590,2020-06-06 21:00:00,1520,-815,2335
node,591,2020-06-13 21:00:00,10748,-66198,76946
node,592,2020-06-20 21:00:00,7846,-6218,14064
node,593,2020-06-27 21:00:00,5667,-3689,9356
node,594,2020-07-04 21:00:00,91396,-4942,96338
node,595,2020-07-11 21:00:00,82971,-46265,129236
node,596,2020-07-18 21:00:00,14073,-7168,21241
node,597,2020-07-25 21:00:00,1812,-1410,3222
node,598,2020-08-01 21:00:00,5416,-2857,8273
node,599,2020-08-08 21:00:00,5675,-2624,8299
node,600,2020-08-15 21:00:00,12810,-3633,16443
node,601,2020-08-22 21:00:00,35661,-11887,47548
node,602,2020-08-29 21:00:00,7567,-1604,9171
node,603,2020-09-05 21:00:00,1777,-1204,2981
node,604,2020-09-12 21:00:00,7897,-7068,14965
node,605,2020-09-19 21:00:00,1932,-1454,3386
node,606,2020-09-26 21:00:00,221614,-306387,528001
node,607,2020-10-03 21:00:00,8605,-6058,14663
node,608,2020-10-10 21:00:00,146711,-77375,224086
node,609,2020-10-17 21:00:00,9843,-2111,11954
node,610,2020-10-24 21:00:00,13978,-12589,26567
node,611,2020-10-31 21:00:00,37804,-87365,125169
node,612,2020-11-07 21:00:00,48910,-33369,82279
node,613,2020-11-14 21:00:00,21102,-10835,31937
node,614,2020-11-21 21:00:00,3009,-526,3535
node,615,2020-11-28 21:00:00,138454,-105849,244303
node,616,2020-12-05 21:00:00,16454,-8242,24696
node,617,2020-12-12 21:00:00,16121,-9107,25228
node,618,2020-12-19 21:00:00,1011,-315,1326
node,619,2020-12-26 21:00:00,11579,-2309,13888
node,620,2021-01-02 21:00:00,29459,-17536,46995
node,621,2021-01-09 21:00:00,7132,-3498,10630
node,622,2021-01-16 21:00:00,2612,-6087,8699
node,623,2021-01-23 21:00:00,18861,-96149,115010
node,624,2021-01-30 21:00:00,9439,-5919,15358
node,625,2021-02-06 21:00:00,81707,-47705,129412
node,626,2021-02-13 21:00:00,2443,-1571,4014
node,627,2021-02-20 21:00:00,83694,-52195,135889
node,628,2021-02-27 21:00:00,45141,-38973,84114
node,629,2021-03-06 21:00:00,192446,-79223,271669
node,630,2021-03-13 21:00:00,1242,-443,1685
node,631,2021-03-20 21:00:00,21622,-13055,34677
node,632,2021-03-27 21:00:00,19946,-17676,37622
node,633,2021-04-03 21:00:00,16818,-10470,27288
node,634,2021-04-10 21:00:00,14362,-12267,26629
node,635,2021-04-17 21:00:00,6050,-7359,13409
node,636,2021-04-24 21:00:00,5497,-2504,8001
node,637,2021-05-01 21:00:00,12188,-10116,22304
node,638,2021-05-08 21:00:00,6393,-2994,9387
node,639,2021-05-15 21:00:00,18224,-48785,67009
node,640,2021-05-22 21:00:00,717,-458,1175
node,641,2021-05-29 21:00:00,10681,-8848,19529
node,642,2021-06-05 21:00:00,85872,-85897,171769
node,643,2021-06-12 21:00:00,45338,-56447,101785
node,644,2021-06-19 21:00:00,29245,-2875,32120
node,645,2021-06-26 21:00:00,4926,-2116,7042
node,646,2021-07-03 21:00:00,3484,-1318,4802
node,647,2021-07-10 21:00:00,86358,-67432,153790
node,648,2021-07-17 21:00:00,1233,-454,1687
node,649,2021-07-24 21:00:00,8222,-3078,11300
node,650,2021-07-31 21:00:00,39419,-30407,69826
node,651,2021-08-07 21:00:00,48464,-10596,59060
node,652,2021-08-14 21:00:00,116514,-139181,255695
node,653,2021-08-21 21:00:00,2643,-790,3433
